vehicle_id,vehicle_localmips,total_tasks,total_task_mips,tasks_completed_local,local_failed,tasks_from_others,other_task_mips,others_completed,others_failed,total_execution_time,total_computation_time,simulation_time,trust_factor,z_score,other_total_comp_time
307,2733.26631,1068,790819.8329,265,0,803,594288.7426,787,16,289.3314237,284.7881212,6000,20834.14372,0.201158326,212.8847397
310,1400.104299,314,235023.5362,269,0,45,34683.77499,26,19,167.8614488,157.9393275,6000,492.8036787,13.76873869,14.85015813
313,1193.868292,380,287256.1731,313,0,67,52298.72333,25,42,240.6096008,212.5960295,6000,-1222.103462,7.935582103,15.79253669
316,1797.806593,428,320964.2627,131,0,297,222200.0457,297,0,178.53103,178.53103,6000,12359.50778,0.461766655,123.5950778
319,1333.797887,322,243113.6927,139,0,183,137793.9103,183,0,182.2717633,182.2717633,6000,10330.94382,0.953057225,103.3094382
322,2440.970433,579,436442.9418,131,0,448,337905.3984,437,11,178.7989465,175.4885264,6000,13180.99223,0.541185581,135.1203424
325,3447.461376,894,677974.0973,198,0,696,528866.9688,696,0,196.6589393,196.6589393,6000,15340.7656,0.172122291,153.407656
328,1628.776322,625,477577.8612,98,0,527,404116.6347,379,148,293.2126744,226.1973841,6000,11407.99976,1.838852914,181.0952878
331,1329.966059,520,387731.875,110,0,410,307362.8936,308,102,291.5351653,234.4870594,6000,11700.96059,2.535870263,174.0577118
334,3346.262682,1096,814734.7644,386,0,710,527816.9045,710,0,243.4760333,243.4760333,6000,15773.32549,0.17645047,157.7332549
337,2007.569599,490,360449.8399,123,0,367,271148.1386,340,27,179.5453767,169.6154413,6000,11520.30127,0.405845892,125.132948
340,3174.263489,742,560500.1248,343,0,399,300090.9741,399,0,176.5764332,176.5764332,6000,9453.877259,0.244046236,94.53877259
343,3096.619735,1039,778826.0717,202,0,837,625505.8362,837,0,251.5084636,251.5084636,6000,20199.63346,0.160983551,201.9963346
346,1198.816188,261,195520.4083,54,0,207,156352.2427,175,32,163.094568,143.1822232,6000,9059.75087,3.703788564,110.5098535
349,1381.59911,440,323835.6577,98,0,342,251675.1194,208,134,234.3919124,162.100904,6000,3758.017298,2.920724755,109.8711814
352,2532.127194,817,619340.9488,171,0,646,488851.3906,624,22,244.593143,238.1499868,6000,18017.32589,0.494191221,186.6164151
355,3163.486354,584,442161.6636,261,0,323,242173.7033,323,0,139.7703717,139.7703717,6000,7655.2789,0.271603903,76.552789
358,2653.102568,809,610934.73,113,0,696,525895.3562,687,9,230.2718098,227.7481232,6000,19317.16336,0.326232837,195.6953202
361,1282.332789,278,211365.6393,123,0,155,119259.1845,113,42,164.8290062,140.6561795,6000,4465.608952,4.850190477,68.82891624
364,3097.484679,951,703496.1285,119,0,832,618056.9652,827,5,227.1185175,225.8151921,6000,19692.84652,0.230610264,198.2317907
367,1279.641137,300,226081.3882,48,0,252,188353.2137,218,34,176.6756176,155.9827598,6000,10580.64998,2.586064842,126.4993575
370,2785.797929,618,461600.4981,143,0,475,356965.2752,441,34,165.6977677,156.8696256,6000,11048.12492,0.752298071,119.3093913
373,1147.000704,278,208985.2104,42,0,236,178008.1303,207,29,182.2014665,163.8200615,6000,11843.16286,3.292269525,136.8130336
376,1969.746992,618,459346.473,84,0,534,397859.1589,484,50,233.2007485,213.9142725,6000,16341.19528,1.114577799,182.6984289
379,1683.800146,526,392743.7807,69,0,457,341300.0617,360,97,233.2484538,190.8863805,6000,11797.21546,1.766262202,160.3342279
382,2776.897915,814,609784.8594,329,0,485,367458.7908,485,0,219.5921054,219.5921054,6000,13232.70794,0.235230071,132.3270794
385,2404.151289,768,582358.0145,269,0,499,374393.5912,499,0,242.2301862,242.2301862,6000,15572.79664,0.275777004,155.7279664
388,1202.648698,361,273930.1708,81,0,280,214799.6316,117,163,227.7723921,123.6050331,6000,-2972.925152,3.961266932,74.43810745
391,1003.320286,245,183355.6096,98,0,147,112032.7625,116,31,182.7488313,159.7920143,6000,6574.837883,5.557664695,88.70519577
394,2803.377092,752,565117.3788,226,0,526,391564.8599,526,0,201.5845033,201.5845033,6000,13967.61288,0.233268715,139.6761288
397,3282.240722,820,616621.9953,222,0,598,449758.8659,598,0,187.8661706,187.8661706,6000,13702.79952,0.185476205,137.0279952
400,2766.959424,854,642719.2595,219,0,635,476754.6219,628,7,232.2835868,230.421949,6000,16857.94397,0.411869776,170.4410775
403,2458.803695,741,556414.4597,145,0,596,446625.9453,556,40,226.2947875,214.446988,6000,15794.79971,0.746598882,169.7957966
406,2013.163534,784,582329.7244,151,0,633,469192.5551,482,151,289.2610136,233.5979299,6000,12173.61482,1.298014534,177.399232
409,2716.672116,655,488346.6498,144,0,511,381306.0371,493,18,179.7591425,174.7453687,6000,13033.02215,0.567587003,135.3439952
412,2118.759525,470,345448.5868,90,0,380,278759.4456,375,5,163.0428478,161.3912794,6000,12826.41517,0.527992453,129.9157201
415,3389.087848,596,452886.3819,194,0,402,307535.5453,401,1,133.6307591,133.3696955,6000,9022.073898,0.300056319,90.48180262
418,2955.739917,617,463334.4353,254,0,363,270164.0571,333,30,156.7575119,149.4566129,6000,7680.139191,0.833698637,84.10229094
421,1766.274069,379,285628.8323,137,0,242,179382.983,231,11,161.7126341,157.0633297,6000,9226.149791,1.319633471,96.91080233
424,3016.698855,819,613662.9229,388,0,431,321372.8451,431,0,203.4220028,203.4220028,6000,10653.12981,0.244795532,106.5312981
427,2328.681906,541,408547.5418,232,0,309,232595.5428,304,5,175.4415408,173.7899924,6000,9657.982073,0.732066676,98.23136914
430,2515.349634,547,406808.8232,214,0,333,248848.8543,303,30,161.7305275,153.4117123,6000,8229.448267,1.095957883,90.61329783
433,2786.052723,871,656614.7225,397,0,474,359371.2628,462,12,235.6792163,232.463021,6000,12255.70069,0.269900986,125.7732023
436,1316.070889,309,231651.4733,89,0,220,166163.8535,129,91,176.0174739,125.5803999,6000,2538.33773,3.916485113,75.82045125
439,2730.785342,851,632266.7242,239,0,612,454807.4288,610,2,231.5329274,230.9147822,6000,16531.19264,0.273319209,165.9300715
442,2091.661296,494,374057.9265,146,0,348,264751.5791,335,13,178.832934,174.0333937,6000,11697.57045,1.300884831,121.7752448
445,3172.432337,598,448747.6592,176,0,422,315196.6716,422,0,141.4522397,141.4522397,6000,9935.489182,0.250973104,99.35489182
448,2240.581578,755,558792.2729,346,0,409,301436.333,409,0,249.3960846,249.3960846,6000,13453.48618,0.324778362,134.5348618
451,2039.752172,479,359174.0347,103,0,376,282390.8242,360,16,176.0870951,170.1644307,6000,12659.83646,0.85626939,132.521029
454,2377.848704,884,662581.0926,386,0,498,370781.3553,498,0,278.647288,278.647288,6000,15593.14327,0.294310076,155.9314327
457,2081.786855,590,443357.3755,196,0,394,296089.7016,384,10,212.9696297,209.6922181,6000,13567.38114,0.65256074,138.9512229
460,1472.606998,349,262903.7948,60,0,289,217238.947,241,48,178.5295026,152.8540966,6000,9616.916279,2.688933259,121.8445687
463,3421.704075,528,402532.531,186,0,342,262490.2291,342,0,117.6409538,117.6409538,6000,7671.330522,0.241777578,76.71330522
466,1022.251286,316,235212.4323,173,0,143,107425.8794,71,72,230.0925767,176.3766672,6000,-234.4272492,7.11820933,51.37163695
469,2892.14821,592,441400.1838,207,0,385,283618.7453,385,0,152.6201812,152.6201812,6000,9806.507989,0.25672847,98.06507989
472,3120.035941,559,417587.8616,152,0,407,305787.1267,406,1,133.8407216,133.6492277,6000,9762.457769,0.260151053,97.81607158
475,1325.065897,419,308376.2606,125,0,294,217109.2156,211,83,232.7252262,187.4583172,6000,7331.404503,3.096411211,118.580954
478,1574.33167,352,263723.9973,165,0,187,142202.3182,157,30,167.5148906,152.2517918,6000,5979.931718,2.894768989,75.06241589
481,2998.777992,719,537340.4302,185,0,534,398864.6544,534,0,179.1864658,179.1864658,6000,13300.90642,0.235451488,133.0090642
484,3114.792482,960,719475.0306,144,0,816,612207.9133,784,32,230.9865054,223.4734412,6000,18152.24111,0.374029493,189.0354753
487,1768.792989,570,424446.1005,127,0,443,327262.2346,402,41,239.9636945,222.6649059,6000,15042.25107,1.331214339,167.7212994
490,1921.862219,467,352366.278,113,0,354,267305.2493,320,34,183.3462745,169.706593,6000,11180.72201,1.317964632,125.4469016
493,2459.959833,696,521109.0844,188,0,508,378626.6269,504,4,211.83642,210.4137863,6000,15107.05086,0.492362858,152.4931424
496,2911.160198,810,608028.9813,208,0,602,454048.7624,592,10,208.8613954,206.5429754,6000,15133.1479,0.336569324,153.649899
499,2502.337571,762,569424.8395,136,0,626,466794.8599,575,51,227.5571633,212.1162272,6000,15566.16482,0.741332719,171.1025843
502,2797.859603,806,609454.0106,330,0,476,359508.2475,473,3,217.8286609,216.8903989,6000,12661.75031,0.338780044,127.5557651
505,2078.237162,441,325325.8595,161,0,280,206985.0137,280,0,156.5393332,156.5393332,6000,9959.643561,0.448313449,99.59643561
508,1070.577619,261,191983.0779,102,0,159,117062.0237,60,99,179.3266312,110.6891699,6000,-2793.018967,6.092620595,40.70727156
511,2465.494988,703,531279.9947,216,0,487,367629.3239,482,5,215.4861386,213.7997248,6000,14573.69153,0.446543306,147.4233291
514,1630.761694,386,292699.2852,114,0,272,205161.811,203,69,179.4862403,147.2143288,6000,6126.352938,2.519818464,93.53544086
517,1850.104925,559,416468.3233,187,0,372,276291.0391,296,76,225.1052455,194.055821,6000,8723.91888,1.745992706,118.2886133
520,2260.397485,642,481987.0646,268,0,374,280458.017,374,0,213.2311099,213.2311099,6000,12407.46457,0.340395851,124.0746457
523,1476.963311,353,268474.9849,94,0,259,198921.2917,177,82,181.7749858,139.1138574,6000,4936.036546,3.066118461,92.02149385
526,1988.349975,626,463551.9005,154,0,472,348716.8009,409,63,233.1339585,210.3682261,6000,12984.85263,1.154783913,152.6142587
529,1438.876192,463,348378.9456,129,0,334,251629.3252,253,81,242.1187781,200.445298,6000,9153.210613,2.819821531,133.2055863
532,2056.974045,646,486616.8009,267,0,379,288337.951,374,5,236.569247,234.9332666,6000,13690.38238,0.56637342,138.5398043
535,1002.953704,233,177281.8839,91,0,142,108119.8674,92,50,176.7597878,139.6869152,6000,3365.570855,8.396068404,70.72858117
538,2501.968559,536,395830.229,235,0,301,225346.6195,292,9,158.2075152,155.3291781,6000,8431.10521,0.793926798,87.18938921
541,3120.304535,810,607371.045,312,0,498,370439.18,494,4,194.6512073,193.7316078,6000,11687.97196,0.275961913,117.7993191
544,2637.975683,626,467494.6413,308,0,318,237690.2992,318,0,177.2171913,177.2171913,6000,9010.329425,0.481318894,90.10329425
547,1774.819362,535,404498.4162,249,0,286,217773.9573,211,75,227.9096255,195.2229324,6000,5732.865436,2.438214228,90.01534744
550,3185.499519,714,533291.0165,227,0,487,362408.0728,487,0,167.4120537,167.4120537,6000,11376.80513,0.217348786,113.7680513
553,1970.423445,739,547700.4262,148,0,591,440151.9167,502,89,277.9607742,244.0296348,6000,15551.70754,1.166804525,189.4482148
556,3246.739269,599,454653.6809,249,0,350,266273.5158,350,0,140.0339366,140.0339366,6000,8201.259594,0.23868391,82.01259594
559,2127.098653,500,371615.1671,90,0,410,302918.2523,375,35,174.7051866,162.465233,6000,11792.92151,1.266692718,130.1691687
562,1155.061068,374,281882.1047,74,0,300,223387.9806,196,104,244.0408672,177.7003363,6000,6071.82197,3.653095233,127.0587506
565,2197.907798,532,395799.586,310,0,222,163022.5104,222,0,180.0801591,180.0801591,6000,7417.167843,0.435217791,74.17167843
568,2527.343169,586,438465.367,232,0,354,267158.0439,354,0,173.488655,173.488655,6000,10570.70711,0.309714251,105.7070711
571,2828.30429,479,355169.0239,198,0,281,206935.7528,281,0,125.5766662,125.5766662,6000,7316.601453,0.312473864,73.16601453
574,1270.555675,405,304100.7015,101,0,304,228203.1847,220,84,239.3446485,189.7147082,6000,8034.908028,3.533645891,129.9790206
577,3017.290334,814,606911.0357,213,0,601,446496.2018,600,1,201.144394,200.8414146,6000,14737.32386,0.211830125,147.676218
580,3429.779593,1038,783084.8914,300,0,738,558453.0425,738,0,228.3193045,228.3193045,6000,16282.4761,0.157921106,162.824761
583,3332.991216,1143,856974.1796,232,0,911,681828.5923,911,0,257.1186433,257.1186433,6000,20456.95737,0.147906934,204.5695737
586,2699.005557,816,614556.4873,116,0,700,526100.6596,694,6,227.6973775,225.9217109,6000,19137.25558,0.28386047,193.1482224
589,1438.446893,354,264846.9579,114,0,240,178967.0486,143,97,184.1200806,135.6738492,6000,2752.439935,3.639150467,75.9706307
592,1537.036105,330,251544.7379,77,0,253,191259.1159,213,40,163.6557119,144.1171613,6000,8535.661608,2.854598686,104.8951666
595,1408.445804,450,339158.2914,140,0,310,234250.037,238,72,240.8032246,202.1074237,6000,8892.650299,3.612197966,127.6223039
598,2704.906619,620,469780.5633,105,0,515,390621.4535,469,46,173.6771835,160.805666,6000,11866.9142,0.601800913,131.5406595
601,3453.445866,924,699828.1416,213,0,711,535233.284,711,0,202.6463332,202.6463332,6000,15498.52828,0.16355216,154.9852828
604,3218.537851,679,501181.6473,169,0,510,375928.1417,509,1,155.7171829,155.5494554,6000,11646.54525,0.219040603,116.63318
607,2018.771088,447,335963.4658,118,0,329,242387.0124,313,16,166.4197926,160.8297489,6000,10888.65283,0.426249578,114.476572
610,1317.077886,373,281162.7869,79,0,294,221799.7573,225,69,213.4746851,172.5321094,6000,8651.776516,3.710852368,127.4603409
613,1024.710795,224,165439.5991,64,0,160,118234.5768,130,30,161.4500404,139.1680287,6000,7081.933883,5.434528775,93.10135051
616,3093.405122,780,591497.5483,220,0,560,427149.3717,553,7,191.2124422,189.7919919,6000,13524.29761,0.297242282,136.6634265
619,2428.49574,606,452174.7407,117,0,489,367332.3727,485,4,186.195402,185.0065333,6000,14888.1483,0.385614079,150.0703517
622,2738.687457,890,666844.1688,152,0,738,550616.1964,697,41,243.4904235,231.8476843,6000,17776.56473,0.541078457,189.4083866
625,1230.207724,484,358110.6385,92,0,392,288332.6842,187,205,291.0976995,167.2066794,6000,-1340.480587,3.403256124,110.4862143
628,3027.04756,660,485054.7997,168,0,492,361809.9882,492,0,160.2402308,160.2402308,6000,11952.57032,0.232153652,119.5257032
631,2367.207719,606,458642.7831,263,0,343,257043.6916,343,0,193.7484317,193.7484317,6000,10858.51865,0.346153827,108.5851865
634,1326.215501,440,330199.3101,80,0,360,269011.3216,262,98,248.9786237,194.2951019,6000,9347.429054,2.860346324,148.1578123
637,1936.732193,588,442390.0744,95,0,493,371083.0618,439,54,228.4208813,207.141805,6000,14904.45187,1.151722287,170.323595
640,2827.867088,1099,826356.4801,242,0,857,642751.8655,857,0,292.2189956,292.2189956,6000,22729.21058,0.202331023,227.2921058
643,2331.559035,927,695193.9946,178,0,749,561362.9213,723,26,298.1670136,290.035685,6000,22450.45345,0.510266516,232.6358631
646,1743.179498,378,281225.8475,114,0,264,196391.766,240,24,161.3292537,150.8487705,6000,9170.199592,1.646596588,102.1824791
649,3217.514423,571,430938.201,149,0,422,321606.0442,420,2,133.9351264,133.5698124,6000,9922.418246,0.262908209,99.58949645
652,1175.40275,282,212453.409,56,0,226,169789.8772,179,47,180.7494571,152.0235004,6000,8700.059635,3.660749768,115.726553
655,1135.498923,277,205455.4127,62,0,215,158827.7083,171,44,180.9384479,151.5018305,6000,8100.158594,4.510601487,110.4382034
658,3441.394719,694,517079.8649,125,0,569,423886.2211,564,5,150.2529954,149.1728117,6000,12101.24319,0.255813615,122.0926156
661,1087.464605,345,256300.3612,92,0,253,188462.0249,160,93,235.686164,170.1245455,6000,4218.081725,4.857745257,107.7424358
664,3117.185068,1141,858250.2143,437,0,704,533766.818,704,0,275.3286044,275.3286044,6000,17123.3599,0.186494256,171.233599
667,2933.424993,686,515537.5113,161,0,525,394445.1664,490,35,175.7459327,167.5062098,6000,11798.62957,0.229420281,126.2260185
670,3002.754587,878,652116.2481,166,0,712,534064.1477,708,4,217.1726757,215.9639368,6000,17544.05963,0.243464687,176.6493351
673,1445.477277,336,254229.968,75,0,261,197426.8368,202,59,175.8796019,145.3379583,6000,7549.916902,2.791112276,106.0408126
676,2444.271976,736,553976.9802,227,0,509,383898.2733,509,0,226.6429372,226.6429372,6000,15706.0375,0.26403493,157.060375
679,2200.986008,474,354862.2473,159,0,315,235000.0895,313,2,161.2287611,160.4831059,6000,10527.90591,0.501637549,106.0247144
682,2137.794763,646,484812.9189,137,0,509,383315.6974,499,10,226.7817881,223.4117956,6000,17256.427,0.519818248,175.9342625
685,1233.963159,385,291371.4268,104,0,281,211492.8548,204,77,236.1265202,187.972875,6000,7508.587735,3.573326136,123.2395226
688,2070.993269,645,483824.51,120,0,525,392902.9651,476,49,233.6195473,216.2893868,6000,15505.68408,0.967112436,172.3870013
691,2734.247007,641,478311.9884,363,0,278,205078.8672,278,0,174.9337156,174.9337156,6000,7500.378227,0.325724135,75.00378227
694,2586.324829,573,427409.9171,117,0,456,337954.179,448,8,165.2576321,162.8500424,6000,12585.44779,0.445493966,128.2620675
697,1014.831992,238,178140.6463,91,0,147,110373.4239,105,42,175.5370818,145.1756025,6000,4803.73336,7.075621166,78.39881288
700,1457.490511,347,260671.5848,67,0,280,212226.4343,201,79,178.8495931,137.8801188,6000,6367.190279,2.827706072,104.6413771
703,1614.99262,348,261681.9406,64,0,284,213921.5801,256,28,162.0329018,148.7435559,6000,10588.10962,1.974978913,119.1704421
706,2853.4956,823,616933.5622,242,0,581,434305.8488,581,0,216.2027382,216.2027382,6000,15220.13382,0.211073884,152.2013382
709,1994.229872,794,588903.3467,176,0,618,460843.7038,588,30,295.3036433,283.7370168,6000,20795.53043,0.70402598,219.5219308
712,3402.43225,631,475625.3325,128,0,503,380894.0718,503,0,139.7898026,139.7898026,6000,11194.75845,0.200738375,111.9475845
715,3119.712639,719,534560.645,174,0,545,401834.4898,545,0,171.3493218,171.3493218,6000,12880.4969,0.206257994,128.804969
718,3090.666472,1167,876857.9452,271,0,896,676105.0169,886,10,283.7116049,281.1562806,6000,21364.63808,0.200698036,216.2017052
721,3445.731045,893,673718.8092,230,0,663,500296.9611,662,1,195.5227499,195.2380644,6000,14462.38999,0.211223731,144.9085854
724,1055.153115,257,188846.8404,34,0,223,165544.0288,116,107,178.9757693,105.5992263,6000,1013.791531,5.039885888,83.51445837
727,1083.86993,337,255877.9261,129,0,208,158041.3823,121,87,236.0780745,174.174239,6000,2200.445827,4.894638531,83.90829374
730,1076.079688,258,192481.204,48,0,210,155718.7392,78,132,178.8726302,87.56750852,6000,-3790.094243,4.986492384,53.4041792
733,1286.800765,279,208753.1224,60,0,219,162783.7183,137,82,162.2264518,115.2104461,6000,3247.064744,3.961099164,79.48665317
736,2557.821734,785,590272.0477,206,0,579,435766.0269,579,0,230.7713786,230.7713786,6000,17036.60662,0.237844345,170.3660662
739,1233.798154,270,202422.2137,53,0,217,162158.9319,150,67,164.0642864,122.6817253,6000,4866.555902,4.129840987,90.04812013
742,1941.363448,601,454112.1978,276,0,325,244987.7572,271,54,233.9140557,213.5473943,6000,8546.033628,1.889004918,105.8269977
745,2971.976413,564,427468.7788,353,0,211,159954.2123,209,2,143.8331667,143.4621321,6000,5307.875238,0.417831764,53.44978699
748,1243.288083,269,203806.7042,47,0,222,169003.0954,144,78,163.9255673,116.1251631,6000,4033.15614,4.550538597,88.13196559
751,2706.886691,634,473979.8434,156,0,478,357134.8901,465,13,175.1014717,171.6981235,6000,12512.89666,0.492396549,128.5323148
754,1992.522327,467,351381.5971,270,0,197,151456.0454,188,9,176.3501429,172.5571295,6000,6842.61931,1.534095859,72.21920655
757,1257.226817,412,307892.125,154,0,258,192398.406,196,62,244.8978346,210.0502829,6000,8333.886269,3.950211241,118.1864144
760,2484.95247,771,580716.3849,177,0,594,447268.5257,570,24,233.6931559,226.0710353,6000,16474.65359,0.568726278,172.3686564
763,2299.470495,546,410549.8768,142,0,404,302733.4344,404,0,178.54105,178.54105,6000,13165.35415,0.328965084,131.6535415
766,2934.472467,595,446634.2761,216,0,379,284371.1148,374,5,152.2025785,150.8659765,6000,9423.386121,0.42844867,95.57046321
769,1553.453019,336,253950.315,105,0,231,174175.4265,187,44,163.4747314,142.171542,6000,6951.508512,2.752379397,90.8182745
772,2825.304031,775,579507.24,264,0,511,382328.8471,511,0,205.1132316,205.1132316,6000,13532.30813,0.239711955,135.3230813
775,1697.867381,502,382574.7645,120,0,382,293895.6325,364,18,225.3266472,216.9606425,6000,15636.49214,1.182597507,164.730926
778,1556.363083,373,278488.4063,90,0,283,212474.2473,259,24,178.9353715,168.0036361,6000,11465.62461,1.674693978,125.5879814
781,2454.501085,755,564143.519,157,0,598,447256.0343,598,0,229.8404031,229.8404031,6000,18221.87152,0.242578224,182.2187152
784,2167.257822,695,512592.453,111,0,584,429689.3338,543,41,236.5166007,222.1042211,6000,16943.93002,0.761092209,183.8516798
787,3038.634731,942,707049.3836,277,0,665,496049.151,665,0,232.686534,232.686534,6000,16324.73775,0.223766435,163.2473775
790,1051.227112,327,246649.8752,76,0,251,186445.1717,106,145,234.6304356,133.3662703,6000,-2516.877668,4.845470494,76.09538864
793,3258.457404,657,488823.0469,242,0,415,309154.6811,415,0,150.0167062,150.0167062,6000,9487.76193,0.224272462,94.8776193
796,1260.413881,408,303192.5127,134,0,274,202441.8028,204,70,240.5499632,198.0863673,6000,7568.814715,3.143447053,118.1517431
799,1301.651334,412,308910.2443,71,0,341,257192.4415,261,80,237.3218052,190.1253159,6000,10319.63717,2.803488982,150.392861
802,1896.406052,411,308793.1907,103,0,308,231181.9336,271,37,162.8307346,147.814179,6000,9187.218073,1.793087562,106.8887364
805,1468.51526,452,344155.6356,120,0,332,252213.9048,258,74,234.3561861,195.8001994,6000,9463.558114,2.400034251,133.1915678
808,2004.704588,645,482365.8668,129,0,516,385735.1258,492,24,240.6169316,231.9796364,6000,17514.03559,0.76757087,183.7776512
811,2454.763313,741,557528.2431,131,0,610,458209.1795,583,27,227.1209775,219.0681458,6000,17055.5583,0.459109055,178.6084147
814,2191.787759,689,514226.141,146,0,543,405289.4157,511,32,234.6149342,223.9401369,6000,16356.3116,0.751208573,174.2379133
817,1979.260015,471,353700.2001,92,0,379,285308.8455,354,25,178.7032515,168.3792207,6000,12350.11879,1.192143987,133.8252187
820,1704.462164,526,397268.4515,158,0,368,275302.2907,239,129,233.0755471,175.8272997,6000,4702.207472,2.32381772,104.2703222
823,2067.006904,492,363393.9786,117,0,375,277159.6463,370,5,175.8068529,174.0577175,6000,13058.91607,0.587291012,132.338296
826,2189.965576,861,644392.4635,183,0,678,506932.6907,636,42,294.2477592,279.1835924,6000,20135.14194,0.400925878,216.4155862
829,2558.66255,583,437032.8013,158,0,425,316779.9571,383,42,170.8051737,158.5255178,6000,9924.754078,0.856942934,111.5271967
832,2625.55993,808,605498.4894,142,0,666,500727.3864,666,0,230.6168991,230.6168991,6000,19071.26098,0.235223975,190.7126098
835,2484.345653,767,576504.5182,118,0,649,485856.1449,641,8,232.0548744,229.483059,6000,19042.3417,0.371214054,192.9952324
838,1408.499053,454,341322.5301,62,0,392,295448.0099,305,87,242.3306778,197.7452323,6000,12058.99955,2.265592598,165.175441
841,2291.404686,543,408850.3275,136,0,407,304518.5683,400,7,178.4278133,176.0472332,6000,12813.4862,0.558198543,130.5154422
844,2261.466029,684,512412.1637,308,0,376,282323.4427,371,5,226.5840642,224.8313167,6000,12133.54,0.561428035,123.0881474
847,3021.91385,918,685060.3965,123,0,795,594142.0693,762,33,226.6975269,218.6875334,6000,18059.12001,0.307879033,188.6011936
850,3474.282221,802,599230.5461,175,0,627,469695.4204,625,2,172.4760707,172.0387722,6000,13431.74773,0.202448871,134.7547758
853,2844.959952,823,613297.193,194,0,629,470576.5564,629,0,215.5732254,215.5732254,6000,16540.70933,0.211520137,165.4070933
856,3448.729059,660,488930.1358,232,0,428,316655.7072,428,0,141.7711068,141.7711068,6000,9181.80877,0.196136602,91.8180877
859,2724.614408,859,641769.0997,197,0,662,491913.707,648,14,235.5449262,231.7052063,6000,17286.48992,0.210872808,176.704619
862,2072.033006,506,378822.3153,93,0,413,311976.9235,380,33,182.8263904,170.6873791,6000,12628.75922,1.087379621,138.4266035
865,3244.469482,711,535518.6052,145,0,566,425217.1351,566,0,165.0558306,165.0558306,6000,13105.90645,0.20760916,131.0590645
868,2255.425769,910,677491.5522,223,0,687,512272.7396,659,28,300.3829971,291.4399105,6000,20924.28888,0.394203168,218.1859755
871,2793.046924,590,451123.9908,164,0,426,324341.618,423,3,161.5167962,160.7959686,6000,11468.30025,0.342695695,115.4038301
874,2084.395182,490,371190.5623,105,0,385,290837.534,367,18,178.0807044,171.1780656,6000,12572.56215,0.905045165,132.6282603
877,3418.618415,733,550163.0573,195,0,538,404117.1573,526,12,160.9314029,158.4239015,6000,11319.56626,0.364118419,115.703164
880,3325.120369,644,482499.8668,230,0,414,312312.1824,411,3,145.1074888,144.4895821,6000,9268.926229,0.247734849,93.307169
883,2759.592927,610,460912.4581,141,0,469,358608.458,461,8,167.0219015,164.9869551,6000,12587.98742,0.406632284,127.9148206
886,1337.210554,304,224609.7044,65,0,239,176182.2326,226,13,167.968839,160.7187631,6000,11725.33943,1.802077005,124.5034703
889,3049.675393,658,492794.2375,178,0,480,358812.1083,467,13,161.5890788,158.1644539,6000,11080.65863,0.459921077,114.2312112
892,2929.707579,877,655681.2162,117,0,760,569838.2701,760,0,223.8043213,223.8043213,6000,19450.34632,0.188007838,194.5034632
895,3033.307799,583,442854.6411,286,0,297,229431.2437,297,0,145.9972645,145.9972645,6000,7563.731044,0.28251979,75.63731044
898,1748.334598,557,414245.6594,92,0,465,346580.1451,394,71,236.9372887,207.4233228,6000,13920.6517,1.464644262,168.7204828
901,1643.732408,624,466741.941,167,0,457,342023.3908,382,75,283.9525087,248.9785276,6000,13812.93314,2.151315523,173.1033125
904,2389.714249,552,418997.998,120,0,432,324207.9894,431,1,175.333933,175.121725,6000,13524.36829,0.347389377,135.455891
907,3379.436777,1082,813610.4372,216,0,866,652563.8424,865,1,240.7532648,240.5343712,6000,19266.06151,0.164247011,192.8795087
910,1933.570877,606,454889.5721,100,0,506,380421.9171,437,69,235.258804,208.5262272,6000,14328.06298,1.259843048,170.0132066
913,1051.868417,252,189365.2455,42,0,210,157055.368,150,60,180.0275037,136.7647265,6000,6278.529612,4.744964931,106.0480733
916,1368.348769,319,240854.5646,160,0,159,119147.9026,134,25,176.0184026,162.3970452,6000,5983.150581,4.195598979,73.4528632
919,1230.500745,297,224622.5845,156,0,141,105549.6901,120,21,182.5456714,170.2951103,6000,6127.671314,3.764297658,73.52727419
922,2320.350081,552,417144.0313,128,0,424,320224.4242,398,26,179.776334,171.6147341,6000,12168.37443,0.609927115,129.8453443
925,1616.952692,358,266768.5449,78,0,280,210382.6211,257,23,164.982282,154.487185,6000,10912.03666,1.739383711,119.6154636
928,2317.6364,728,547945.4773,148,0,580,438295.0449,537,43,236.4242628,223.1253267,6000,16251.50728,0.544442633,175.8140089
931,2710.899797,555,415351.9955,137,0,418,315066.3368,416,2,153.215547,152.5809707,6000,11495.28991,0.348359075,115.5874755
934,2346.573194,535,401901.9418,376,0,159,119290.5733,159,0,171.2718542,171.2718542,6000,5083.607602,0.491809364,50.83607602
937,1317.108687,284,213021.405,55,0,229,170444.4225,116,113,161.7341128,98.20511928,6000,235.0029259,3.962622463,65.87902279
940,2039.544452,482,359617.4653,158,0,324,241497.4718,313,11,176.3224454,171.876313,6000,10951.52901,1.192432621,113.9614225
943,1083.987642,346,257670.354,100,0,246,182874.3952,119,127,237.7059886,150.4529482,6000,-580.0840893,4.47711354,81.45219952
946,2291.152279,548,408932.9523,157,0,391,291071.278,346,45,178.4835325,164.5343531,6000,9914.307823,0.986503765,113.0922576
949,1154.196385,358,272434.5342,78,0,280,212346.0916,147,133,236.0382841,149.5137568,6000,1092.838143,4.338958237,97.45290878
952,2330.357258,754,565569.9664,274,0,480,361197.1439,450,30,242.6966786,232.7735875,6000,13515.02857,0.811430794,145.0733768
955,2492.650203,583,434241.5096,295,0,288,217091.1796,288,0,174.2087634,174.2087634,6000,8709.251677,0.362736523,87.09251677
958,1301.560259,308,232683.3246,98,0,210,156713.8557,176,34,178.7726101,159.2788822,6000,8141.715446,3.221064139,100.9108824
961,1032.106146,245,185791.7331,63,0,182,138638.1381,118,64,180.0122341,132.7229144,6000,3974.682572,5.351697458,87.03614544
964,2635.938077,984,740897.6893,175,0,809,606194.4454,795,14,281.075529,277.0016905,6000,22182.52691,0.331807959,225.8991076
967,1131.152343,356,267521.5666,59,0,297,223729.0106,199,98,236.5035693,171.9828471,6000,6874.713095,3.685596123,133.2678532
970,1575.948251,368,271025.8214,79,0,289,212351.5453,260,29,171.9763458,159.0755233,6000,10894.36076,2.248749986,121.8444301
973,1012.189429,306,230357.2217,76,0,230,173880.9737,124,106,227.5831135,149.4819637,6000,1558.468884,5.826559046,93.68583862
976,3010.862112,834,624766.1231,170,0,664,493731.3999,664,0,207.5040636,207.5040636,6000,16398.33979,0.194045431,163.9833979
979,1635.624539,395,295832.3261,64,0,331,247534.6626,268,63,180.8681143,150.5130326,6000,9062.937482,2.249256899,120.9844566
982,1757.442888,529,397666.8729,121,0,408,308806.9805,271,137,226.2758441,167.9144791,6000,5899.107703,2.058770978,117.352442
985,1720.121575,551,407891.7567,179,0,372,271235.7266,334,38,237.1296091,220.7018884,6000,12482.8603,1.451684254,141.2563236
988,1333.827737,305,226000.5877,122,0,183,135684.2857,116,67,169.4376128,131.0947393,6000,2503.974721,4.224628751,63.38262069
991,1746.038314,532,395365.9399,119,0,413,304739.7811,363,50,226.4360047,205.2816157,6000,13222.33493,1.401776562,153.3777382
994,3362.202157,916,683848.9494,145,0,771,574738.0715,770,1,203.3931684,203.1277324,6000,17041.00901,0.170617651,170.6755261
997,1363.393476,327,245251.503,108,0,219,165496.6024,106,113,179.8831426,116.6282781,6000,-512.3932971,3.876050028,58.13093156
1000,1879.817707,434,330502.0534,70,0,364,277526.6804,346,18,175.8160125,168.4741132,6000,13295.10914,1.026459094,140.2929907
1003,2960.343617,681,509100.2583,90,0,591,440101.3314,575,16,171.9733667,168.1021436,6000,14092.3178,0.369823523,144.7944011
1006,2301.848966,503,381327.8978,118,0,385,294113.0717,364,21,165.6615632,158.6278883,6000,11370.51827,0.863046959,120.7388576
1009,1723.745758,406,303207.5548,70,0,336,251667.2926,299,37,175.9003921,160.1066544,6000,11441.27636,1.583571297,130.2065012
1012,1295.762256,409,303303.511,85,0,324,240189.1101,222,102,234.0734264,175.1016965,6000,6742.164802,3.022826168,126.3933779
1015,1090.40109,233,177069.545,56,0,177,136105.0581,107,70,162.3893691,112.4666114,6000,2497.557967,5.376208204,74.89833739
1018,1132.754924,361,274001.8733,63,0,298,224977.0615,216,82,241.88981,186.8346299,6000,8850.017482,3.557627303,143.5553549
1021,1767.488228,415,315746.1216,96,0,319,242422.5114,304,15,178.6411454,172.4776981,6000,12482.96122,1.101356251,130.9930596
1024,2994.94039,768,581839.2384,208,0,560,422069.1525,559,1,194.2740631,194.020355,6000,14041.99806,0.22427252,140.6736887
1027,1572.987904,509,382354.5338,125,0,384,290137.0587,293,91,243.0753172,200.5296034,6000,9935.821625,2.055559157,141.9039301
1030,3248.156611,962,719254.5478,174,0,788,585245.5515,778,10,221.4346886,219.0591185,6000,17542.66102,0.275460904,177.8021804
1033,2605.862162,751,559548.5475,147,0,604,451642.355,597,7,214.72684,213.0248934,6000,16991.3929,0.332776163,171.6158757
1036,1717.954176,699,521808.822,209,0,490,364779.887,383,107,303.7384985,256.7796107,6000,11841.6111,1.665371914,165.3749987
1039,2501.274807,806,607013.6023,122,0,684,513690.7327,650,34,242.681692,232.6030556,6000,18521.42966,0.594469547,195.292933
1042,1622.594564,378,285239.2955,125,0,253,190639.3635,181,72,175.7920936,141.0222684,6000,4795.079826,3.779448036,82.72062353
1045,2394.013473,530,398467.2421,69,0,461,346526.4898,440,21,166.4431912,159.8195048,6000,13149.97199,0.757005082,138.1234062
1048,2297.630061,550,415616.6917,70,0,480,361165.07,459,21,180.8892993,174.0125817,6000,14343.68263,0.697624059,150.3135439
1051,2562.806827,593,442770.9532,192,0,401,300535.9966,401,0,172.7679778,172.7679778,6000,11726.82987,0.298845855,117.2682987
1054,1882.885653,454,337552.2215,86,0,368,271298.7036,297,71,179.2738826,150.5718285,6000,8668.255106,1.655812973,115.3846052
1057,2919.441992,1120,841154.2556,164,0,956,714362.3151,905,51,288.1215856,275.5860049,6000,21962.02273,0.451749217,232.155808
1060,2352.90104,734,550553.8417,130,0,604,454382.4063,558,46,233.9893741,219.345105,6000,16382.72786,0.380641369,178.4715477
1063,2488.975343,563,421748.7063,120,0,443,333281.5673,424,19,169.4467193,163.8847146,6000,12277.91119,0.652309455,128.3411166
1066,1163.38523,253,187547.0063,53,0,200,149672.8148,79,121,161.2080001,82.64561662,6000,-2847.192623,4.586575116,50.09045728
1069,2706.660349,576,432767.1273,216,0,360,271953.1616,359,1,159.8897059,159.6603807,6000,10001.68901,0.350427265,100.2462153
1072,1221.793161,392,293950.7346,239,0,153,111939.3605,47,106,240.5896054,177.0463556,6000,-3546.758729,4.693790267,28.07566251
1075,2980.863759,795,601091.4317,178,0,617,466589.5829,613,4,201.6500855,200.50815,6000,15424.44446,0.287697998,155.3863801
1078,3245.556879,605,449205.5732,171,0,434,323484.0504,434,0,138.4063167,138.4063167,6000,9966.981399,0.231592335,99.66981399
1081,1832.311814,421,323792.1713,131,0,290,224331.5473,248,42,176.7123744,158.8126009,6000,8663.133283,1.997175633,104.5311063
1084,3148.874934,920,683403.3289,201,0,719,538476.3248,714,5,217.0309533,215.8901557,6000,16872.43468,0.250776095,169.8651445
1087,3080.601338,627,470583.3831,132,0,495,370952.0348,495,0,152.7569885,152.7569885,6000,12041.54625,0.22481064,120.4154625
1090,2364.540865,565,424567.6531,164,0,401,299332.7267,397,4,179.5560649,178.1648113,6000,12380.98181,0.531021182,125.2010718
1093,1439.620705,343,253886.8471,105,0,238,176188.509,183,55,176.3567628,148.5541391,6000,6678.01202,2.886734676,94.58274383
1096,1786.709883,688,507099.6979,160,0,528,389527.3227,441,87,283.8175927,246.9635973,6000,14430.57598,1.412546441,181.1597551
1099,2804.610615,830,619115.6969,182,0,648,484403.0889,639,9,220.7492525,218.149269,6000,16751.67324,0.343179214,170.116716
1102,3032.909721,626,474919.4295,256,0,370,278553.7533,367,3,156.5887129,155.7789632,6000,9022.423449,0.352784884,91.03398419
1105,1082.728496,327,245808.7459,229,0,98,72196.69028,44,54,227.0271328,191.4603571,6000,-445.3224261,8.515719755,31.11355144
1108,1872.242905,567,425719.6027,134,0,433,324926.5379,356,77,227.384813,196.7224116,6000,11222.45466,1.553234154,142.886948
1111,3099.052555,583,443280.9176,411,0,172,133169.8386,172,0,143.0375606,143.0375606,6000,4297.114563,0.366261291,42.97114563
1114,1406.539803,342,252003.7826,77,0,265,195238.749,216,49,179.165767,153.3192957,6000,8711.489531,2.725388937,112.9613666
1117,2089.207932,475,356950.7696,150,0,325,243996.9227,317,8,170.8545924,167.901482,6000,11088.29791,0.742759645,113.8360895
1120,3287.191294,1184,885765.4137,202,0,982,732807.08,982,0,269.4596494,269.4596494,6000,22292.80302,0.149829379,222.9280302
1123,2176.593293,472,349291.0877,99,0,373,275312.5225,364,9,160.4760471,157.6519537,6000,12083.96249,0.64676814,123.6637183
1126,2007.004131,608,455253.344,226,0,382,290013.1364,368,14,226.8322904,221.6575369,6000,13415.10109,0.836460864,139.3257644
1129,1584.693001,484,364253.9069,282,0,202,150459.1124,182,20,229.8577117,220.5620834,6000,7635.401823,2.03082579,85.64964652
1132,2175.251626,857,639176.1493,172,0,685,511950.0011,628,57,293.8400973,274.0447156,6000,19576.13196,0.884178153,215.5567013
1135,2287.225412,703,527482.9019,165,0,538,403353.6662,518,20,230.6213018,223.5663895,6000,16224.08158,0.628898519,169.2957281
1138,2520.158272,786,589358.4931,318,0,468,348678.2794,468,0,233.8577302,233.8577302,6000,13835.5707,0.279066353,138.355707
1141,3103.055984,655,489791.0232,161,0,494,372728.7794,494,0,157.8415039,157.8415039,6000,12011.66789,0.241211991,120.1166789
1144,1454.14197,345,261755.5883,65,0,280,211991.3878,247,33,180.0069,163.7438078,6000,11325.83345,2.287029133,129.5214268
1147,2121.052372,842,634321.4795,357,0,485,367109.6843,454,31,299.0597912,288.1529453,6000,15126.53368,0.598998178,162.1721828
1150,2366.914241,760,568482.2823,255,0,505,377408.7383,470,35,240.1786564,228.8872372,6000,13686.89625,0.510166731,148.1603817
1153,1924.666466,465,350299.1977,145,0,320,240262.1407,297,23,182.0051442,172.7453984,6000,10631.36392,1.275650455,115.573385
1156,1953.004782,453,341526.2099,96,0,357,269221.5573,335,22,174.8721832,165.9668769,6000,12003.93097,1.054448238,128.9446159
1159,2629.77532,823,612849.6663,245,0,578,430406.8467,577,1,233.0425956,232.7022567,6000,16298.60977,0.258264445,163.3264366
1162,1435.031572,346,262745.4722,77,0,269,206007.7245,217,52,183.0938617,154.8921667,6000,8715.284139,2.665047101,115.3545364
1165,3128.728578,821,615364.0987,368,0,453,339169.4555,453,0,196.6818416,196.6818416,6000,10840.4883,0.302798553,108.404883
1168,3093.865562,939,704055.3514,241,0,698,521936.4557,697,1,227.5649466,227.2853405,6000,16814.12195,0.237778694,168.4208256
1171,1183.203509,382,284823.6286,99,0,283,211516.9455,191,92,240.7224341,181.3190201,6000,5995.949928,4.054986292,119.3629132
1174,1230.955043,395,296526.7643,118,0,277,206658.6008,216,61,240.891628,203.3633436,6000,9282.819831,3.046577307,130.3564828
1177,2953.674942,809,609328.9534,219,0,590,445396.6334,590,0,206.2951968,206.2951968,6000,15079.4059,0.218381035,150.794059
1180,1510.61172,334,246220.3691,150,0,184,135658.8261,161,23,162.9938162,151.4921152,6000,6680.04996,2.330390037,78.30220054
1183,1136.057294,266,199942.9236,130,0,136,103247.4491,106,30,175.9972184,156.5409667,6000,5196.975205,4.173747888,71.42600371
1186,3028.229786,626,468611.8436,169,0,457,340040.8948,453,4,154.7477823,153.9084101,6000,11061.15767,0.30704708,111.4509489
1189,3056.686395,917,688486.0306,147,0,770,579385.4471,745,25,225.2393415,218.6724672,6000,17641.31568,0.41020454,182.9800311
1192,3373.945985,655,485192.661,190,0,465,344678.3092,465,0,143.8056991,143.8056991,6000,10215.88107,0.19656558,102.1588107
1195,1068.56567,226,172430.6479,48,0,178,135991.5025,139,39,161.3664493,134.427355,6000,7338.727242,4.197911303,100.3263667
1198,2477.137785,762,569130.5662,106,0,656,488972.0523,637,19,229.7532942,224.3426583,6000,18657.26944,0.245146745,191.9833303
1201,1346.728317,304,231479.7146,47,0,257,195684.4428,222,35,171.8830084,151.1979187,6000,10393.33984,2.445590376,124.6184881
1204,2490.420973,746,560904.3614,260,0,486,364590.9902,486,0,225.2247181,225.2247181,6000,14639.73337,0.263823845,146.3973337
1207,1015.851614,380,290918.8974,96,0,284,217113.0738,158,126,286.3793231,189.9178805,6000,2080.229958,4.793857496,117.2637422
1210,3153.172253,758,566873.1599,203,0,555,414016.519,555,0,179.7786846,179.7786846,6000,13130.15864,0.202484229,131.3015864
1213,3248.792225,624,463274.4014,221,0,403,298759.142,403,0,142.5989627,142.5989627,6000,9196.006431,0.228874489,91.96006431
1216,3189.418651,603,450208.7632,265,0,338,251615.7696,338,0,141.1569983,141.1569983,6000,7889.079393,0.303396527,78.89079393
1219,3298.434077,903,676358.1888,145,0,758,567323.5454,739,19,205.0543297,200.6289165,6000,16314.70162,0.31683102,167.5724294
1222,2953.480963,886,660525.6555,169,0,717,536992.686,702,15,223.6431058,219.6861963,6000,17390.30583,0.342828052,177.8599678
1225,2617.908681,673,498851.6354,331,0,342,251788.113,342,0,190.5534899,190.5534899,6000,9617.910465,0.30678546,96.17910465
1228,1624.960747,382,291512.2653,211,0,171,132243.1264,171,0,179.3964967,179.3964967,6000,8138.235135,0.688658576,81.38235135
1231,1409.757392,317,236268.3873,76,0,241,178945.0483,162,79,167.5950689,126.0065304,6000,4375.614524,3.290811657,85.34468371
1234,1234.287495,385,287514.9987,162,0,223,166607.212,130,93,232.9400565,175.9424029,6000,2098.719297,4.082608908,77.98484658
1237,2881.560874,612,462059.8474,166,0,446,336999.5433,440,6,160.3505418,158.8784878,6000,11400.62386,0.373626494,115.4782927
1240,2079.892605,786,589157.0522,95,0,691,518346.7404,612,79,283.2632083,254.2012139,6000,19109.40425,0.888651678,220.1560369
1243,1607.931646,394,294122.3995,78,0,316,233816.5112,292,24,182.9197156,172.0509721,6000,12367.69723,1.996871916,134.5457159
1246,1627.333249,462,346731.6373,70,0,392,293398.2661,318,74,213.0673834,178.9431075,6000,11204.53533,1.805107078,146.1696291
1249,1326.663124,436,329828.4646,330,0,106,78521.73974,34,72,248.6150844,206.869351,6000,-2430.406765,5.368632538,17.44166569
1252,3279.642868,762,571830.4173,168,0,594,445852.736,593,1,174.3575262,174.1224935,6000,13547.54487,0.216632522,135.7104814
1255,2339.233982,576,433849.7209,144,0,432,324493.8483,415,17,185.4665776,179.7936925,6000,12737.22249,0.858627769,133.0451101
1258,1634.830688,558,414291.9499,54,0,504,374505.784,330,174,253.4158142,174.5730479,6000,7139.371503,1.975261929,150.2364813
1261,1633.858571,386,289140.5209,39,0,347,260067.7649,285,62,176.9679004,149.6908542,6000,10461.98835,1.93506457,131.8969297
1264,1174.077985,383,289793.909,41,0,342,256976.196,179,163,246.8267974,142.7413794,6000,1070.405922,3.712283749,114.7894772
1267,2281.09391,501,378968.7241,48,0,453,343222.6053,445,8,166.1346438,163.6632761,6000,14552.13046,0.549702128,147.9926723
1270,2857.532113,566,425767.3081,114,0,452,341749.5602,452,0,148.9982584,148.9982584,6000,11959.60523,0.242293941,119.5960523
1273,3295.12284,631,472543.1605,185,0,446,335990.8141,446,0,143.406842,143.406842,6000,10196.60967,0.203101737,101.9660967
1276,1670.649296,517,386565.6935,62,0,455,341075.8758,409,46,231.3865,210.5237228,6000,16243.21204,1.293883877,183.2948976
1279,2382.686217,937,708757.2614,124,0,813,615163.9551,756,57,297.461435,279.415944,6000,22208.9869,0.578288262,240.13536
1282,1436.967895,448,332582.4908,100,0,348,257732.5998,252,96,231.4474053,182.7451833,6000,8195.419075,2.536539821,130.6564127
1285,2035.841767,638,482236.9765,208,0,430,327427.7286,351,79,236.8735057,208.0964989,6000,10327.76059,1.431038906,132.0546127
1288,2287.698592,537,398999.7669,99,0,438,323868.9818,427,11,174.4109859,170.9731753,6000,13469.41567,0.631902194,138.1319674
1291,3426.393212,1081,803563.9752,320,0,761,564282.9443,756,5,234.5218209,233.4319593,6000,16250.74301,0.206417153,163.5972917
1294,2984.45557,787,594486.5414,183,0,604,455631.5422,601,3,199.1943011,198.4214124,6000,15112.24502,0.261833881,151.8953389
1297,3298.301438,1097,818893.9453,192,0,905,675196.952,902,3,248.2774727,247.6384216,6000,20343.24024,0.193977586,204.0714535
1300,1677.932175,665,494969.3529,134,0,531,395474.6472,427,104,294.9876999,249.763295,6000,14524.28667,1.553479591,190.4672715
1303,2754.141929,815,611214.9243,187,0,628,472247.5094,625,3,221.9257177,221.0491728,6000,16971.50196,0.286469532,170.5915645
1306,1773.181852,691,520613.8498,95,0,596,449599.2375,452,144,293.6043189,231.6156288,6000,12957.76835,1.784799493,191.5663737
1309,3273.697951,827,623670.1456,257,0,570,433057.2514,569,1,190.5093735,190.2415625,6000,13174.81922,0.21060992,132.0160032
1312,2252.516824,533,398164.5824,100,0,433,322756.9255,423,10,176.7643101,173.4863315,6000,13673.12858,0.582680655,140.0092644
1315,3334.341436,614,457921.6695,128,0,486,362815.7835,485,1,137.3349665,137.1332254,6000,10840.83448,0.225291237,108.6100859
1318,3406.382285,612,463356.2729,207,0,405,306568.0996,403,2,136.0259167,135.5957567,6000,8913.782883,0.243777786,89.5679888
1321,2364.125813,939,710769.6706,309,0,630,479420.3768,628,2,300.6479887,299.9607169,6000,20141.51617,0.311818197,202.1024335
1324,1257.466992,284,214724.4991,165,0,119,90008.30875,90,29,170.7595511,154.0116635,6000,3808.328756,8.887389227,54.83117516
1327,2653.380391,621,463699.9415,114,0,507,380653.4174,479,28,174.7581851,166.7479389,6000,12743.93065,0.650121658,135.4495527
1330,2346.218617,539,408086.2073,198,0,341,259169.0559,341,0,173.9335816,173.9335816,6000,11046.24497,0.366209913,110.4624497
1333,1297.139532,313,232731.3694,59,0,254,188767.8885,149,105,179.4189165,118.8001976,6000,2428.884047,3.688648591,84.90755938
1336,1399.589094,327,247043.8427,97,0,230,173309.3333,166,64,176.5116945,142.1448749,6000,5509.508592,3.267437086,89.46190553
1339,1278.182684,282,211760.6123,59,0,223,171257.5122,145,78,165.6731975,118.6912045,6000,4002.117462,4.012450468,87.00316761
1342,1536.524176,356,270431.197,87,0,269,204743.3505,208,61,176.0019148,145.5284929,6000,7230.413519,2.616672652,102.777557
1345,2943.524833,1118,843275.6274,227,0,891,673402.5147,878,13,286.4849713,282.9971022,6000,22179.84535,0.271736722,225.2863227
1348,3479.169179,591,439202.0833,166,0,425,315724.6138,415,10,126.2376334,124.1506715,6000,8657.320515,0.426715925,88.66016701
1351,1695.601696,669,496987.2041,233,0,436,323964.4083,372,64,293.1037433,265.2751214,6000,13540.43771,1.436027702,163.232999
1354,2474.194224,584,435665.4218,193,0,391,293109.2439,391,0,176.08376,176.08376,6000,11846.6546,0.302635383,118.466546
1357,3281.168978,911,684897.731,300,0,611,457016.9796,610,1,208.7358912,208.4439903,6000,13870.10027,0.211634256,138.9929036
1360,2926.054746,623,461154.5587,240,0,383,283636.0344,375,8,157.6028471,155.7013955,6000,9313.172691,0.47966761,95.03317849
1363,2791.408244,849,633139.7349,204,0,645,482501.9081,639,6,226.8173193,225.2219832,6000,16966.18331,0.296986977,171.2571692
1366,2589.218112,566,429083.6114,176,0,390,296570.9612,381,9,165.7193766,163.1908111,6000,10948.36099,0.593685218,112.0121755
1369,2033.243134,613,461370.7831,110,0,503,377621.9128,471,32,226.9137298,216.2465972,6000,16438.96684,0.939539991,175.056801
1372,3085.554415,612,460683.505,141,0,471,352562.0157,471,0,149.3033157,149.3033157,6000,11426.21287,0.250311065,114.2621287
1375,2401.694504,530,399680.4911,116,0,414,313068.6684,413,1,166.416041,166.1135196,6000,12974.82007,0.320971957,130.0507221
1378,3182.858241,1008,752435.7677,217,0,791,588020.2462,789,2,236.4025384,235.8561641,6000,18365.32255,0.203544385,184.1995998
1381,1476.127601,559,418918.4656,118,0,441,331508.4027,276,165,283.7955644,199.8722945,6000,5673.323397,2.893374718,140.6565039
1384,1168.898275,252,187847.6017,53,0,199,148719.6634,171,28,160.7048327,143.2195927,6000,9226.014952,3.137590507,109.7453895
1387,2884.943337,653,489603.0897,411,0,242,182363.2206,242,0,169.7097768,169.7097768,6000,6321.206322,0.593152421,63.21206322
1390,3198.258229,802,596313.4076,280,0,522,389235.6133,522,0,186.4494249,186.4494249,6000,12170.23722,0.212087666,121.7023722
1393,1715.518822,385,286245.9613,76,0,309,230442.4586,249,60,166.8567885,140.509813,6000,8163.419246,2.259372285,107.981168
1396,1868.592954,466,345675.3554,163,0,303,225920.7627,294,9,184.9923252,181.0171667,6000,11295.38972,1.068771228,116.9290557
1399,2972.023981,1061,796972.2021,297,0,764,570837.8815,763,1,268.1580658,267.8599177,6000,19147.41197,0.194489961,191.7722677
1402,1822.617355,731,550084.6321,155,0,576,434475.0066,507,69,301.8102679,273.3174359,6000,18139.40516,1.265765021,209.8868836
1405,1790.938361,707,521785.8674,384,0,323,238556.5272,235,88,291.3477532,253.9816872,6000,5846.984333,2.187671238,95.83590928
1408,1871.29329,455,336943.4434,202,0,253,185892.6645,252,1,180.0591309,179.6612235,6000,9854.332443,0.478205288,98.94123179
1411,1336.051736,320,240495.4815,132,0,188,141975.4926,160,28,180.0046173,163.4660307,6000,7318.779304,6.863763441,89.72637962
1414,2624.428061,876,647612.7088,282,0,594,438589.7462,579,15,246.7633685,242.2453791,6000,15808.22411,0.633008693,162.6002306
1417,3273.126817,626,470035.8065,315,0,311,235187.3192,307,4,143.6045203,142.7056075,6000,7005.619408,0.404299849,70.95510696
1420,2576.74374,1025,768433.1091,297,0,728,542764.0428,728,0,298.218677,298.218677,6000,21063.95116,0.234492164,210.6395116
1423,3106.423798,893,673826.8929,248,0,645,487842.9882,592,53,216.9140261,204.2195714,6000,13165.43725,0.584277925,144.3488272
1426,3050.071208,1033,781566.9712,388,0,645,484343.9509,645,0,256.2454834,256.2454834,6000,15879.75879,0.203337032,158.7975879
1429,2639.973692,824,616735.635,220,0,604,453475.7476,604,0,233.614311,233.614311,6000,17177.28283,0.2151682,171.7728283
1432,1980.624006,431,323466.2373,71,0,360,270159.7386,318,42,163.3153169,146.9029245,6000,10357.65401,1.308156379,119.9889325
1435,2809.233291,616,463855.4339,197,0,419,315567.8762,419,0,165.1181606,165.1181606,6000,11233.23852,0.287237515,112.3323852
1438,1340.942053,315,240077.1584,73,0,242,185475.4483,234,8,179.0361916,174.1425068,6000,12852.99036,1.75374579,133.4235884
1441,3194.690899,512,384286.474,255,0,257,193406.2124,257,0,120.289094,120.289094,6000,6053.988273,0.295882444,60.53988273
1444,1584.500317,511,379810.1489,170,0,341,250062.5991,312,29,239.7034225,226.1537723,6000,13071.86542,1.538248518,144.2683044
1447,1920.168703,596,453403.4382,198,0,398,304880.0015,348,50,236.1268765,216.3206465,6000,11916.52562,1.376677896,138.9714863
1450,1224.387116,355,266198.9613,176,0,179,133029.7111,74,105,217.4140497,154.8965931,6000,-1638.487148,4.621583491,46.13258506
1453,1471.913465,454,343743.736,235,0,219,164598.5969,130,89,233.5352887,188.3204576,6000,2139.66108,3.480694957,66.61144187
1456,3087.940904,852,637917.3948,276,0,576,430292.8162,576,0,206.5834207,206.5834207,6000,13934.61953,0.202695945,139.3461953
1459,1836.878154,574,426222.8349,158,0,416,310184.5904,394,22,232.0365311,222.6999206,6000,15019.18665,1.01078601,159.5284771
1462,1175.840975,278,210041.4005,57,0,221,167818.1669,198,23,178.6307886,163.6732118,6000,11280.66691,2.898854795,127.7642458
1465,3320.93146,697,521552.8974,154,0,543,404815.0199,543,0,157.0501842,157.0501842,6000,12189.80352,0.214314921,121.8980352
1468,2303.167446,557,421557.5953,167,0,390,298446.421,390,0,183.0338458,183.0338458,6000,12958.08611,0.381593309,129.5808611
1471,1653.412407,524,391329.8853,101,0,423,315221.8851,303,120,236.6801432,182.7712881,6000,8283.156984,2.32664922,136.740425
1474,1186.682795,288,215013.8703,70,0,218,163267.4533,169,49,181.1890011,149.6680101,6000,7454.108062,4.245226416,106.0620716
1477,1631.128453,381,286803.6982,64,0,317,238235.2822,225,92,175.8314605,133.9928064,6000,6237.819217,2.601553055,104.2168462
1480,2585.350579,774,582939.348,230,0,544,410951.4464,532,12,225.4778724,221.5957188,6000,15118.95497,0.319272177,155.0717034
1483,3474.972301,628,465927.7094,234,0,394,293234.7134,394,0,134.0809851,134.0809851,6000,8438.476281,0.213010251,84.38476281
1486,2436.328843,579,437517.4937,232,0,347,262669.3812,347,0,179.5806403,179.5806403,6000,10781.35991,0.33864629,107.8135991
1489,1232.780213,390,295055.0338,110,0,280,212925.1471,162,118,239.34115,165.9509901,6000,2593.915201,3.851363326,99.3293119
1492,1263.777272,279,209233.893,93,0,186,141195.15,146,40,165.5623167,141.3766724,6000,6335.342192,5.607537853,87.53906627
1495,2077.055231,646,484491.8716,173,0,473,352947.5997,427,46,233.2590219,217.0888046,6000,13758.64861,1.08963327,153.7567034
1498,2250.397751,539,404619.4911,174,0,365,275714.2421,341,24,179.7991004,172.3800595,6000,10767.99229,0.926018289,115.0989638
1501,1094.928184,337,256095.0357,132,0,205,155307.848,61,144,233.892085,134.5552702,6000,-5683.067547,4.580509617,42.50613928
1504,3043.521386,867,656599.1559,562,0,305,229477.0617,305,0,215.7366658,215.7366658,6000,7539.853764,0.298705494,75.39853764
1814,1700.578934,545,412807.6591,146,0,399,304628.9953,315,84,242.745368,205.6187364,6000,10487.926,1.880129292,142.0058916
1817,2873.955041,579,430987.1043,168,0,411,305674.3202,411,0,149.9630642,149.9630642,6000,10636.01608,0.316161389,106.3601608
1820,3416.551213,611,453660.7754,153,0,458,339573.6634,458,0,132.7832505,132.7832505,6000,9939.077223,0.198836196,99.39077223
1823,1200.72525,289,213889.1953,89,0,200,147389.4943,173,27,178.1333368,162.0988845,6000,9068.148667,3.933422502,106.715939
1826,1809.690656,568,427370.6066,204,0,364,273381.3572,272,92,236.1567184,198.237366,6000,7522.653752,1.971964922,113.1458898
1829,1169.641098,278,209928.2991,77,0,201,151205.7934,182,19,179.4809532,166.437925,6000,10318.93202,5.029992668,116.2323484
1832,3385.746896,634,475766.7353,224,0,410,307055.4847,410,0,140.5204671,140.5204671,6000,9069.061988,0.248687142,90.69061988
1835,2933.0191,652,486973.4987,178,0,474,352822.1069,474,0,166.0314789,166.0314789,6000,12029.31501,0.229116682,120.2931501
1838,2764.242237,777,581516.6229,220,0,557,417596.4168,539,18,210.3710794,205.8692439,6000,14206.71763,0.461345054,146.5690118
1841,2197.041276,513,387360.3564,214,0,299,225815.1078,277,22,176.3100041,168.4080436,6000,8697.753796,0.402254605,94.87949846
1844,3118.835336,815,610715.5393,241,0,574,426748.9594,574,0,195.8152558,195.8152558,6000,13682.95897,0.196230862,136.8295897
1847,1229.830036,403,298286.2217,128,0,275,203175.0599,163,112,242.5426384,176.2709705,6000,3266.246817,3.666152244,98.93413608
1850,1026.366375,229,170515.6752,51,0,178,132729.5947,141,37,166.1352899,138.5978548,6000,7424.502764,5.38724092,101.7824627
1853,2751.595937,1078,806319.0836,294,0,784,585650.4743,781,3,293.0368782,292.2173116,6000,21120.11557,0.24101551,212.0207223
1856,2103.629939,646,486402.5247,163,0,483,364376.1091,464,19,231.2205753,224.7120066,6000,16019.58894,0.628059094,166.7044581
1859,2339.479724,558,420036.8029,188,0,370,280183.3814,353,17,179.5428268,174.3994374,6000,10947.63371,0.948932325,114.6197265
1862,1274.13142,307,228873.0344,62,0,245,183492.1443,220,25,179.6306336,166.1215001,6000,11699.52478,2.391504912,130.5043813
1865,2673.576878,631,471396.9196,98,0,533,397553.9172,496,37,176.3169496,166.1328668,6000,12832.92294,0.776847311,138.5133123
1868,1915.625046,610,455209.4849,136,0,474,353121.13,394,80,237.6297418,205.7769605,6000,12063.17277,1.450885539,152.4845089
1871,1471.69548,346,259551.3638,138,0,208,159932.2224,191,17,176.3621396,167.4922505,6000,9093.231084,5.254646469,99.80219999
1874,1653.093659,510,385960.949,197,0,313,236903.9205,252,61,233.4779684,205.6987342,6000,8775.096794,2.135020327,115.5302022
1877,1912.639736,453,335020.785,239,0,214,159625.1363,209,5,175.1614685,173.2204901,6000,7957.606883,0.9708639,81.51704728
1880,1379.634266,417,314973.073,100,0,317,238901.3418,207,110,228.3018629,168.8444145,6000,5424.790998,3.659768644,113.7053584
1883,1824.029276,547,413260.1804,151,0,396,296726.1557,322,74,226.5644449,196.1356572,6000,10181.86271,1.705591324,132.2474148
1886,2798.988819,611,457422.4409,141,0,470,351583.5349,467,3,163.4241758,162.7629199,6000,12428.83989,0.397004042,124.9496548
1889,1022.43675,320,241326.2128,63,0,257,194529.7243,136,121,236.0304565,149.0112994,6000,1622.257416,5.458108466,103.2417312
1892,3366.109859,653,483962.6748,169,0,484,358683.3186,483,1,143.7750683,143.6152623,6000,10623.7611,0.22126586,106.397417
1895,3478.280984,673,505585.2034,216,0,457,343052.8161,457,0,145.3549054,145.3549054,6000,9862.711426,0.216130845,98.62711426
1898,3364.755568,642,490543.993,227,0,415,315780.2315,415,0,145.7888941,145.7888941,6000,9384.938227,0.291502695,93.84938227
1901,2151.999617,594,449971.5799,140,0,454,343858.4701,453,1,209.0946376,208.775293,6000,15914.68738,0.358610188,159.4662183
1904,1895.429322,460,344395.1486,152,0,308,233055.2374,287,21,181.6977002,173.1848711,6000,10593.07796,1.273215932,114.4436087
1907,1296.673299,421,312769.4095,145,0,276,207032.4771,161,115,241.2091077,174.2345169,6000,2571.515116,3.611019036,92.68974195
1910,1443.705599,450,336769.5146,133,0,317,237895.1557,220,97,233.2674438,182.4888122,6000,6322.366992,3.289635778,114.0023015
1913,3328.385864,661,495515.8015,151,0,510,379750.2006,510,0,148.8757079,148.8757079,6000,11409.44037,0.198072261,114.0944037
1916,3261.145886,1151,857245.9639,212,0,939,701134.9257,936,3,262.8664874,262.272949,6000,21380.94153,0.169295366,214.4029537
1919,2891.563601,588,441971.4164,179,0,409,307569.2316,409,0,152.848589,152.848589,6000,10636.77906,0.248613154,106.3677906
1922,1694.263097,404,303407.5421,115,0,289,216810.452,219,70,179.0793547,148.012595,6000,6583.388576,2.668675941,96.90064542
1925,1889.210773,451,337903.7693,117,0,334,250510.9563,329,5,178.8597515,176.8249462,6000,12853.12404,0.69971386,130.5660457
1928,2130.033995,665,502065.656,200,0,465,353446.1285,423,42,235.7078137,220.8318475,6000,13618.25688,1.044486942,151.058535
1931,1189.640758,385,286614.6587,198,0,187,142316.8569,117,70,240.9253859,195.4725069,6000,2872.435391,4.631162963,74.17723286
1934,2053.720004,588,436577.3209,134,0,454,337521.0797,450,4,212.5787936,211.2093331,6000,16160.72796,0.464898726,162.9767401
1937,2462.800454,515,382843.0025,69,0,446,332601.819,430,16,155.4502728,150.3394148,6000,12482.85347,0.394087853,129.9393928
1940,1214.764966,290,216951.3585,83,0,207,153924.2224,142,65,178.595337,138.6759207,6000,4687.228168,4.854991366,86.79169797
1943,2282.59183,534,393595.0383,119,0,415,307618.8894,393,22,172.4333861,165.458103,6000,12081.68003,0.687828387,127.7920833
1946,1472.720584,468,352281.0071,144,0,324,242794.6069,242,82,239.2042394,196.8208821,6000,8009.456973,3.33732085,122.477927
1949,1991.143161,569,430396.5951,112,0,457,347387.0938,440,17,216.1555248,209.4341981,6000,16102.35027,0.768500385,167.7448294
1952,1511.153045,486,365509.3009,186,0,300,225705.5658,252,48,241.8744429,217.8245401,6000,10126.0027,2.272292185,125.3099298
1955,1978.165281,572,429855.6977,107,0,465,350028.1674,419,46,217.3001931,200.6112615,6000,14356.8002,1.063692985,160.2569336
1958,1199.985801,373,279866.6633,100,0,273,208323.4716,175,98,233.2249791,170.1637384,6000,4748.246573,3.78867252,110.5437065
1961,1170.538439,378,282664.7442,56,0,322,240345.985,189,133,241.4826671,156.2278056,6000,3481.970233,3.630204554,120.0745638
1964,1235.839651,291,217724.0278,67,0,224,167816.4053,152,72,176.1749816,132.2168694,6000,4787.51828,4.095260794,91.83329501
1967,1021.805634,389,289529.383,62,0,327,242246.1459,151,176,283.3507405,154.3904603,6000,-2084.401874,4.195112889,108.1162615
1970,1851.886544,436,322800.3465,62,0,374,277261.7223,323,51,174.3089216,153.7630812,6000,10862.68443,1.522527576,129.1726848
1973,2359.442324,893,664088.975,106,0,787,586870.1771,728,59,281.4601435,262.6260398,6000,21106.43729,0.648604082,229.8984766
1976,1735.374672,561,416867.8291,123,0,438,325665.9196,362,76,240.2177673,207.3300906,6000,12188.7821,1.685721173,154.7754977
1979,3107.896223,694,519494.9008,123,0,571,426332.9129,567,4,167.1532328,166.0726306,6000,13501.61279,0.278273419,136.0967301
1982,2538.918978,604,457231.703,79,0,525,398832.3519,482,43,180.0891273,167.8513107,6000,13261.18341,0.595537362,144.8496507
1985,2694.443324,832,628247.8437,148,0,684,518963.514,681,3,233.1642451,232.4889395,6000,19125.44843,0.246935541,191.92979
1988,1074.828312,254,193886.0975,56,0,198,149449.4249,163,35,180.3879701,157.1359512,6000,9254.088968,3.265411934,115.7929087
1991,3124.957452,588,441635.7002,126,0,462,346089.7109,461,1,141.3253483,141.1110424,6000,11032.16036,0.248654149,110.5359095
1994,2972.597654,571,421972.4439,152,0,419,308033.8356,415,4,141.9541065,140.914091,6000,10154.4432,0.353298337,102.5844475
1997,2143.35585,669,500329.5088,296,0,373,277584.9578,370,3,233.4327773,232.5570525,6000,12775.80566,0.471551151,128.6337814
2000,2942.377382,617,462705.9833,204,0,413,308838.8316,412,1,157.2558252,156.9594788,6000,10436.96527,0.265895041,104.6659992
2003,1218.422174,288,217531.3433,26,0,262,198925.6286,172,90,178.5352794,121.915259,6000,5002.49036,3.829959866,106.644924
2006,2993.060422,831,628326.582,179,0,652,488746.3821,614,38,209.9277974,200.4356889,6000,14430.89722,0.419188412,153.8010808
2009,1446.084748,541,410202.4114,116,0,425,321901.0459,276,149,283.6641574,205.2277908,6000,6572.905168,2.573395887,144.1654183
2012,1325.813146,329,247920.97,68,0,261,195721.3717,150,111,186.9954079,123.9334965,6000,2149.982413,3.601691564,84.5617355
2015,1209.137752,369,274886.2662,107,0,262,194543.7428,183,79,227.3407357,180.0123215,6000,6623.777798,3.517130365,113.5661922
2018,3221.389513,800,599042.9787,328,0,472,350824.4548,470,2,185.9579465,185.4865549,6000,10796.19156,0.236089753,108.4333073
2021,1606.774408,381,289100.6211,90,0,291,223128.4554,278,13,179.9260803,173.7321202,6000,12647.93995,1.295127926,132.6733596
2024,2316.925196,556,423159.7759,320,0,236,178998.4544,199,37,182.6385145,169.6019381,6000,5118.374563,1.754474817,64.22032199
2027,3059.71168,909,685302.1163,196,0,713,539119.1387,697,16,223.9760435,220.264022,6000,16877.52839,0.395892009,172.4873054
2030,2380.825873,782,584158.7997,160,0,622,463211.6887,580,42,245.3597326,232.0506805,6000,16794.11425,0.733120728,181.2501947
2033,2999.974176,651,490549.552,170,0,481,363367.3024,480,1,163.5179249,163.2998481,6000,12068.73231,0.266462988,120.9053999
2036,1533.664632,586,436258.4174,116,0,470,346241.424,333,137,284.4548986,217.9348566,6000,9272.076138,2.153317419,159.2408034
2039,2113.338046,508,383766.3707,82,0,426,320637.8356,401,25,181.5925149,172.7190838,6000,13397.41727,0.987392709,142.8476038
2042,1403.598747,566,423636.9482,205,0,361,268296.8631,196,165,301.8219767,212.4560635,6000,1241.743465,2.916085957,101.7833478
2045,2512.279035,812,605224.0864,306,0,506,377200.1776,506,0,240.9063953,240.9063953,6000,15014.26284,0.32416534,150.1426284
2048,2243.001769,540,407206.5726,327,0,213,161276.6509,213,0,181.545364,181.545364,6000,7190.215057,0.469002109,71.90215057
2051,3405.18004,886,658606.1995,212,0,674,502219.3961,674,0,193.413033,193.413033,6000,14748.68848,0.163563289,147.4868848
2054,1579.312426,516,382763.5218,101,0,415,310593.288,352,63,242.3608625,212.5395339,6000,13702.0956,1.406774512,166.8422846
2057,3454.983066,818,611734.5848,272,0,546,414592.2261,542,4,177.0586348,176.2444337,6000,11836.9936,0.253724614,119.1841371
2060,3013.700045,664,493789.4997,181,0,483,359346.6925,483,0,163.8482571,163.8482571,6000,11923.77102,0.224557598,119.2377102
2063,1827.173053,587,441307.1835,156,0,431,323391.2962,399,32,241.5245686,227.7711897,6000,14948.32079,1.472479131,163.2365869
2066,2415.3102,532,397002.3153,154,0,378,280597.5379,377,1,164.3690799,164.0318814,6000,11550.01374,0.373420298,115.8373359
2069,2532.382247,806,603826.0938,120,0,686,515218.8748,686,0,238.4419234,238.4419234,6000,20345.22534,0.235307436,203.4522534
2072,2419.694131,530,397804.9926,76,0,454,341375.7705,454,0,164.4030076,164.4030076,6000,14108.21996,0.288431378,141.0821996
2075,1849.563505,520,394139.9384,124,0,396,299458.8056,328,68,213.0988947,184.8498565,6000,10540.97494,1.561382709,133.6587876
2078,2738.6188,803,602063.8498,98,0,705,528528.0859,704,1,219.8421517,219.6014751,6000,19250.93929,0.236789508,192.7500696
2081,3460.795425,799,603094.1656,125,0,674,509751.8136,674,0,174.2646101,174.2646101,6000,14729.32523,0.178120415,147.2932523
2084,3378.553492,888,663131.008,136,0,752,562962.1858,752,0,196.2766046,196.2766046,6000,16662.81701,0.159824829,166.6281701
2087,1080.232166,254,190176.6731,31,0,223,167249.0212,199,24,176.0516665,158.9280335,6000,12057.96558,3.692448489,137.7032889
2090,3212.939399,817,612496.7199,236,0,581,433438.4097,581,0,190.634383,190.634383,6000,13490.40103,0.227886249,134.9040103
2093,1435.527919,455,345504.4578,114,0,341,259819.6959,296,45,240.6811134,216.4021208,6000,13243.44514,1.847140101,156.713444
2096,1394.786299,452,338262.8738,104,0,348,259114.8509,298,50,242.5194985,216.5057985,6000,13374.64717,2.061031011,159.7601717
2099,2975.645687,690,517605.0592,272,0,418,315282.3216,418,0,173.9471407,173.9471407,6000,10595.42549,0.272664919,105.9542549
2102,1126.617582,355,264301.9813,64,0,291,216073.9057,145,146,234.5977779,140.2930688,6000,318.0510422,4.144097779,97.4852195
2105,1726.976042,541,407544.0604,74,0,467,353518.0182,312,155,235.9870957,167.5436294,6000,6781.655482,1.963527207,136.2600211
2108,3437.543707,982,730170.4384,226,0,756,560556.0203,754,2,212.4105177,212.0282698,6000,16230.4273,0.17746919,162.686521
2111,3442.221279,606,449690.936,148,0,458,341594.8226,458,0,130.6397525,130.6397525,6000,9923.674131,0.199057285,99.23674131
2114,3038.50382,863,640887.251,430,0,433,319737.963,431,2,210.921983,210.4398759,6000,10426.45372,0.283792706,104.7466443
2117,1217.225734,382,287470.9898,138,0,244,186028.9612,119,125,236.1690045,157.8725275,6000,-376.2664518,4.327674354,74.53381246
2120,1321.575721,385,287377.6,99,0,286,213693.1082,225,61,217.450726,183.3068713,6000,9340.798823,2.651224762,127.5518429
2123,1672.499016,402,301234.6175,201,0,201,150587.2474,143,58,180.1104902,153.4939865,6000,3680.426384,2.957766475,63.42076751
2126,1745.564916,506,379762.7985,98,0,408,307111.7261,360,48,217.5586797,195.9462985,6000,13271.35387,1.727314578,154.32592
2129,2008.207562,475,358483.2708,146,0,329,249561.9967,308,21,178.5090733,170.838932,6000,10893.07347,1.188667503,116.600876
2132,3240.088749,641,482764.6225,156,0,485,366215.7402,485,0,148.9973454,148.9973454,6000,11302.64535,0.234583399,113.0264535
2135,1002.883792,419,313121.4214,86,0,333,249312.6827,178,155,312.2210407,197.4474956,6000,1904.869393,4.181920426,133.822239
2138,1260.995758,560,418409.7241,88,0,472,352979.4819,256,216,331.8089864,203.0801664,6000,2246.358889,2.80642973,151.1924088
2141,1936.87391,608,458139.8051,147,0,461,347674.4183,345,116,236.5356891,191.7867316,6000,9000.495107,1.637516453,134.7539086
2144,1012.766848,321,242530.9393,110,0,211,160102.3282,101,110,239.4736161,156.351948,6000,-815.9243433,4.615776959,74.96242461
2147,2768.567404,869,643787.4221,262,0,607,450473.2551,598,9,232.5344947,230.2727312,6000,15818.63477,0.357437454,160.4481111
2150,3080.240728,621,466865.6356,281,0,340,256644.4248,340,0,151.5679055,151.5679055,6000,8331.959979,0.258230823,83.31959979
2153,2573.567452,571,432715.7661,171,0,400,303042.5208,381,19,168.138498,162.8707287,6000,10721.6386,0.70686894,112.4841553
2156,2088.262516,495,376419.3216,190,0,305,231297.2694,305,0,180.2547901,180.2547901,6000,11076.06288,0.397455529,110.7606288
2159,1542.834505,337,255516.1839,165,0,172,130049.4298,146,26,165.6147714,153.3065845,6000,5967.616006,1.953753924,71.98434697
2162,1969.344484,710,532481.2371,159,0,551,411773.1303,519,32,270.3850146,258.0263529,6000,18437.41451,0.845287474,196.7328068
2165,2648.663886,559,413710.2194,190,0,369,271539.2789,369,0,156.1958169,156.1958169,6000,10251.9342,0.284241778,102.519342
2168,3318.829512,1089,812336.6568,459,0,630,468088.0936,630,0,244.7660098,244.7660098,6000,14104.01143,0.172512353,141.0401143
2171,3109.076876,663,493710.4313,218,0,445,330640.6527,440,5,158.7964695,157.4779278,6000,10370.98055,0.340165445,105.0283471
2174,2953.375347,646,489380.5896,109,0,537,408493.4694,519,18,165.7021313,160.9890742,6000,12888.79913,0.486787415,133.6010484
2177,1457.720964,352,265672.3571,62,0,290,218759.1435,276,14,182.25186,175.339542,6000,13624.46494,1.484748269,143.1569674
2180,2856.951216,1070,798495.4874,165,0,905,676183.1852,900,5,279.4921673,278.0882993,6000,23387.22538,0.172082014,235.2761219
2183,2315.329034,535,404982.3686,174,0,361,274095.6855,361,0,174.9135274,174.9135274,6000,11838.30382,0.329362281,118.3830382
2186,2044.28573,533,400077.7515,80,0,453,339954.4102,427,26,195.7053975,186.1553877,6000,14719.49387,0.933983614,156.7449485
2189,2207.689139,701,520277.209,154,0,547,405599.8121,513,34,235.665973,224.4487074,6000,16128.69018,0.920446514,172.5041674
2192,2485.409191,785,590797.6763,112,0,673,505977.8688,668,5,237.706402,236.1398441,6000,20044.61864,0.312786095,202.0127443
2195,1816.835074,442,331292.0923,200,0,242,183271.1417,226,16,182.3457159,175.5672685,6000,8731.695125,1.507778241,94.0953987
2198,3061.773762,624,466816.8376,196,0,428,321002.09,428,0,152.4661434,152.4661434,6000,10484.18711,0.235119253,104.8418711
2201,3467.374496,993,743041.4742,241,0,752,562226.0094,735,17,214.2951317,210.7628098,6000,15508.28284,0.286442321,158.6151503
2204,2614.660904,750,559929.0276,136,0,614,458216.2282,608,6,214.1497686,212.3943754,6000,17173.80297,0.330773733,173.493423
2207,1430.22152,557,418439.4866,82,0,475,358593.6071,305,170,292.5697039,203.5418341,6000,7267.018083,2.60810769,161.6980507
2210,2146.017404,515,382110.2297,138,0,377,280014.5458,377,0,178.055513,178.055513,6000,13048.10228,0.359940201,130.4810228
2213,2479.264051,930,692841.6388,135,0,795,589388.8943,777,18,279.4545577,274.1537777,6000,22712.57987,0.418620022,232.4265787
2216,2279.76447,536,401702.0123,155,0,381,285467.2996,381,0,176.2032954,176.2032954,6000,12521.78913,0.386994999,125.2178913
2219,2811.488485,888,657821.7222,151,0,737,547637.277,730,7,233.9763175,232.006039,6000,19084.49739,0.294704545,192.8152524
2222,2639.047058,556,414261.3229,79,0,477,354917.1666,459,18,156.9738295,151.9940973,6000,12452.7401,0.659255509,129.5071332
2225,2402.611049,571,423672.6177,204,0,367,269826.9607,367,0,176.3384123,176.3384123,6000,11230.57187,0.321798591,112.3057187
2228,3110.17693,800,598956.4376,403,0,397,300352.2926,397,0,192.5795384,192.5795384,6000,9657.080586,0.23243233,96.57080586
2231,1562.613181,342,255354.4022,66,0,276,204416.6895,206,70,163.4149803,128.7995243,6000,6158.629343,2.630691518,96.20174943
2234,2783.747834,1028,773372.4165,598,0,430,323796.9251,429,1,277.8169801,277.540038,6000,11576.30183,0.324112435,116.0399604
2237,2003.964584,478,358414.9027,100,0,378,281845.34,373,5,178.8529126,177.0437616,6000,13702.55707,0.5843544,138.8347217
2240,2448.834293,802,597517.6486,194,0,608,453415.1834,608,0,244.0008498,244.0008498,6000,18515.55185,0.256079818,185.1555185
2243,3155.732067,740,550240.477,192,0,548,405567.4099,533,15,174.3622289,170.9426385,6000,12167.85138,0.383799101,125.0981042
2246,3409.222166,564,421560.6945,168,0,396,295680.1979,394,2,123.6530428,123.1745557,6000,8577.254448,0.330917711,86.25103163
2249,3007.601768,853,636307.1759,386,0,467,353866.1474,467,0,211.5662993,211.5662993,6000,11765.72481,0.227396858,117.6572481
2252,2603.534953,864,640657.9856,173,0,691,512354.3382,644,47,246.0723583,233.1212001,6000,17088.94869,0.605800156,183.8406451
2255,2658.925706,626,469351.218,141,0,485,360900.9718,482,3,176.519117,175.6981149,6000,13408.98708,0.346895729,134.9108729
2258,2215.036309,527,393352.7662,104,0,423,316170.4901,423,0,177.582988,177.582988,6000,14273.82878,0.321643692,142.7382878
2261,2056.331089,484,362221.6812,63,0,421,313369.8539,392,29,176.1494942,164.9511034,6000,12999.59219,0.706836441,141.1943127
2264,1744.176306,523,394830.6216,212,0,311,231560.4054,305,6,226.3708206,223.6267171,6000,12727.38335,0.489631258,130.017937
2267,1160.073311,282,210370.1454,62,0,220,165738.9667,183,37,181.3421129,157.9563302,6000,9609.782498,4.193629306,119.4836076
2270,2458.700522,541,402892.0904,178,0,363,273814.2989,360,3,163.8638325,163.0117486,6000,10966.1286,0.470928077,110.5133698
2273,2346.918323,533,399921.0802,61,0,472,353940.67,444,28,170.4026409,161.6488459,6000,13330.32272,0.796983905,142.0570221
2276,1008.561521,240,180068.8086,48,0,192,144677.7711,108,84,178.5402326,115.5339979,6000,1743.71546,5.671081271,80.44338935
2279,2246.415646,522,394944.5699,61,0,461,349743.8846,437,24,175.810995,167.8309455,6000,13972.96485,0.84607069,147.709698
2282,2565.230526,631,467829.8199,111,0,520,384411.023,455,65,182.3734027,164.6609412,6000,11442.94541,0.880594884,132.1419157
2285,2771.543337,593,443415.9289,194,0,399,296140.5471,399,0,159.9888131,159.9888131,6000,10685.04119,0.297194031,106.8504119
2288,2873.026448,589,443353.0022,79,0,510,384671.6992,477,33,154.3156703,145.9972939,6000,11725.40087,0.608417035,125.5723852
2291,1230.594444,493,372043.5508,101,0,392,295774.8757,247,145,302.32832,214.0303412,6000,6375.526216,3.488679704,152.053241
2294,1447.33297,328,240528.0329,41,0,287,210649.1062,192,95,166.187075,118.4670206,6000,5010.283841,3.026968777,97.82289285
2297,2863.121067,1013,751190.6048,350,0,663,492364.2929,658,5,262.3677404,260.8932481,6000,16901.86974,0.379328132,170.4931897
2300,1979.255085,470,350728.9598,88,0,382,284457.5381,328,54,177.2025054,156.3973324,6000,10210.91474,1.462094803,122.9143204
2303,1043.512424,410,311702.3112,209,0,201,154085.6387,163,38,298.7049353,271.3361672,6000,9292.303318,4.111003477,120.2918013
2306,3207.274952,1115,842197.1841,313,0,802,608817.5335,801,1,262.5896428,262.4152141,6000,18947.50718,0.172629908,189.6495005
2309,3048.521089,926,697486.1005,265,0,661,499583.0926,660,1,228.7949075,228.5038979,6000,16329.51784,0.212507639,163.5861879
2312,1993.818215,598,447658.4682,148,0,450,338263.078,446,4,224.5232113,223.1220639,6000,16685.36326,0.476085713,168.2547799
2315,2003.457104,610,455079.2511,154,0,456,339255.8384,429,27,227.1469902,217.1788865,6000,14939.90071,1.14953781,159.3671108
2318,3479.497854,879,664348.5266,264,0,615,463359.5465,611,4,190.9322995,190.2144297,6000,13173.27707,0.248129815,132.4506406
2321,2067.786619,804,602112.7585,248,0,556,419874.3183,478,78,291.1870852,262.9225011,6000,14652.57865,1.106101994,174.7903706
2324,1396.320658,341,254902.0154,97,0,244,183085.8649,228,16,182.552635,174.5975853,6000,11521.01155,1.371937481,123.1651653
2327,2761.908509,800,601453.1785,247,0,553,417387.6325,542,11,217.7672347,214.6833576,6000,14495.51491,0.249897812,148.0390262
2330,3052.983849,912,682354.7372,233,0,679,507147.8366,677,2,223.504208,223.0082253,6000,16512.35011,0.220538995,165.6194838
2333,2562.234846,607,457810.7931,168,0,439,333011.577,420,19,178.6763589,172.9242007,6000,11846.48694,0.308889554,124.2170276
2336,3169.514634,810,600447.7992,302,0,508,374578.4981,508,0,189.4447159,189.4447159,6000,11818.16591,0.210988125,118.1816591
2339,1949.425242,419,320890.2418,62,0,357,275140.0831,326,31,164.607616,152.6828842,6000,11728.96152,1.268291337,129.2143471
2342,2626.951182,570,424619.0127,313,0,257,190658.3062,257,0,161.6394761,161.6394761,6000,7257.778808,0.393739424,72.57778808
2345,3322.045833,660,494464.5799,291,0,369,277670.6935,369,0,148.8433949,148.8433949,6000,8358.424519,0.251964108,83.58424519
2348,3334.178021,616,464560.1249,202,0,414,311860.2065,414,0,139.3327297,139.3327297,6000,9353.435975,0.243729844,93.53435975
2351,3375.69434,734,550375.891,253,0,481,359476.7792,473,8,163.0407957,161.2082339,6000,10282.46066,0.28125601,104.6571683
2354,2845.578918,662,496851.7558,264,0,398,299952.3477,375,23,174.6048063,168.5620038,6000,9332.435075,0.292767685,99.36715323
2357,1807.488968,571,421819.6187,174,0,397,294377.4061,302,95,233.3732743,194.0699746,6000,8425.879633,1.77380898,123.562096
2360,3462.684422,860,644927.0698,320,0,540,405233.1459,540,0,186.2506054,186.2506054,6000,11702.86103,0.200444159,117.0286103
2363,1107.413789,260,193910.1564,57,0,203,152297.1595,191,12,175.1018077,166.8180362,6000,12095.75276,3.141211755,129.2412991
2366,2540.207738,593,444429.4883,131,0,462,345379.1269,462,0,174.9579303,174.9579303,6000,13596.49141,0.300634585,135.9649141
2369,2579.561896,549,409374.3416,271,0,278,207979.5647,278,0,158.6991738,158.6991738,6000,8062.59253,0.375610888,80.6259253
2372,1857.650413,718,548283.3983,222,0,496,380001.2938,413,83,295.1488581,260.4544762,6000,13517.14113,1.478780859,169.8657932
2375,1393.726837,433,324197.6483,76,0,357,266779.5414,278,79,232.612044,191.011018,6000,10821.24593,2.584790434,149.8134853
2378,2395.786157,560,421803.3319,94,0,466,350418.1382,454,12,176.0605097,172.3877487,6000,13891.88419,0.551311428,142.5916029
2381,2619.447816,824,615931.6868,332,0,492,369834.2864,482,10,235.1379871,232.4027778,6000,13571.74624,0.46758764,138.4526717
2384,3326.272298,665,497452.2662,227,0,438,325765.9166,438,0,149.5524785,149.5524785,6000,9793.723645,0.206722541,97.93723645
2387,1199.136486,394,290008.6086,134,0,260,190790.3101,159,101,241.847873,180.5316243,6000,3647.391995,3.776178644,97.7901686
2390,1333.591456,318,238846.9496,138,0,180,135896.8814,163,17,179.1005397,169.8017521,6000,8330.535825,1.9182919,92.60414585
2393,2218.034913,739,551408.3237,163,0,576,433330.668,532,44,248.6021841,233.8146538,6000,16579.18679,0.839491246,180.5793982
2396,1117.510331,265,202707.504,90,0,175,133671.8276,158,17,181.3920628,169.2242196,6000,9528.005595,3.15029122,107.4478991
2399,1419.344695,305,229768.733,151,0,154,115941.7979,127,27,161.8836734,147.6641991,6000,5324.790178,3.358208172,67.46737614
2402,2250.386027,697,522600.1593,101,0,596,444175.9576,589,7,232.2268948,229.8995921,6000,19272.30675,0.373918485,195.0503703
2405,2396.595089,536,399941.7793,86,0,450,336033.4277,419,31,166.8791617,157.159843,6000,12077.42126,0.822167732,130.4935313
2408,1151.427237,272,203028.1823,110,0,162,121634.4454,100,62,176.3274098,135.2413498,6000,2346.585824,5.312754435,64.55191822
2411,2892.412219,882,666221.9638,367,0,515,387338.9626,504,11,230.3343761,227.6705546,6000,12858.79034,0.400917383,131.2517249
2414,3223.050072,591,442750.0092,185,0,406,303932.0791,403,3,137.3698824,136.6541174,6000,9286.799152,0.315803317,93.58375644
2417,2981.429664,607,460683.8108,285,0,322,242452.1124,322,0,154.5177524,154.5177524,6000,8132.075536,0.285441038,81.32075536
2420,3490.170124,709,529333.8334,214,0,495,368593.9145,495,0,151.6641925,151.6641925,6000,10560.91541,0.189526824,105.6091541
2423,2354.840436,715,536037.2218,155,0,560,417654.3741,528,32,227.632078,218.2242551,6000,15854.43009,0.60003898,167.9521238
2426,2412.962696,920,692582.4282,137,0,783,590145.3133,737,46,287.0257503,272.7936537,6000,21610.87189,0.562538476,230.3408155
2429,1344.923891,400,302475.4503,76,0,324,245130.6981,210,114,224.901537,161.8029687,6000,5606.648413,3.619371711,119.1650524
2432,3242.353318,579,437253.7156,235,0,344,257622.0697,344,0,134.8568995,134.8568995,6000,7945.52735,0.236146527,79.4552735
2435,2790.293649,624,466310.2607,166,0,458,343065.0369,458,0,167.1187048,167.1187048,6000,12294.94383,0.252387735,122.9494383
2438,1133.796591,344,256427.1046,59,0,285,212324.6091,228,57,226.1667627,187.2277614,6000,10939.06933,3.380582621,148.3296946
2441,3301.074497,1047,783594.8141,416,0,631,474118.2798,631,0,237.3756832,237.3756832,6000,14362.54408,0.181544262,143.6254408
2444,3039.62984,977,735658.7472,159,0,818,617965.5121,818,0,242.0224784,242.0224784,6000,20330.28838,0.168197103,203.3028838
2447,1944.259137,458,342571.2869,144,0,314,233683.7685,306,8,176.1963107,173.3843709,6000,11456.77986,0.934991781,117.3797384
2450,2340.620978,749,562105.0904,129,0,620,465505.4422,609,11,240.1521201,236.0799489,6000,19073.6829,0.486227281,194.8090002
2453,3339.57131,756,570289.8983,178,0,578,434946.9617,575,3,170.7673966,170.1092568,6000,12892.40781,0.23123034,129.5822179
2456,3296.998418,876,656344.3453,157,0,719,534414.198,719,0,199.073297,199.073297,6000,16209.11297,0.158370951,162.0911297
2459,3003.756986,643,483396.3285,183,0,460,344734.7203,459,1,160.9305716,160.6267865,6000,11416.02763,0.261180499,114.4640613
2462,2955.133471,603,444180.074,111,0,492,360461.8912,491,1,150.3079567,150.0722529,6000,12150.68023,0.253660898,121.7425062
2465,2233.087941,879,666001.9568,240,0,639,485433.9776,622,17,298.2426015,292.2982009,6000,20549.35817,0.518453727,211.4379822
2468,2506.715912,518,393927.7356,86,0,432,330276.5281,387,45,157.1489349,142.9323562,6000,10332.35074,0.833292267,117.5400861
2471,3490.773797,649,489183.9855,118,0,531,397758.6295,531,0,140.1362603,140.1362603,6000,11394.56902,0.185805543,113.9456902
2474,1442.396568,339,253605.8448,98,0,241,180583.9125,221,20,175.8225514,165.3766209,6000,10430.52702,1.862933783,114.7512007
2477,2213.567688,496,370017.7707,91,0,405,303184.3823,387,18,167.1590043,161.0788671,6000,12480.61188,0.67833633,130.886256
2480,1849.521298,446,329536.9197,90,0,356,262778.1812,319,37,178.1741687,163.8429981,6000,11341.6683,1.282335199,127.7478536
2483,1082.659002,331,245534.5521,52,0,279,205886.7966,157,122,226.7884456,142.7614947,6000,2211.38206,4.260145406,106.1407715
2486,1725.630556,686,515421.0012,174,0,512,385114.9184,435,77,298.6856019,265.2050644,6000,15621.23714,1.310006333,189.6929089
2489,2882.287557,597,448193.2907,173,0,424,316257.0706,421,3,155.4991588,154.6773545,6000,10808.07211,0.35072716,108.9025254
2492,1656.468015,513,381352.5944,149,0,364,273588.1305,306,58,230.2203187,203.8166242,6000,11235.61566,2.046337918,138.7598511
2495,3455.38118,1058,805485.2929,321,0,737,556553.4991,725,12,233.1104011,230.8713314,6000,15659.04867,0.272443639,158.8295564
2498,2597.889784,611,458707.1168,175,0,436,326128.6972,407,29,176.5691214,168.1059254,6000,10860.961,0.74377298,117.072806
2501,2544.296335,579,428389.68,210,0,369,272085.9281,368,1,168.3725571,168.1599789,6000,10651.44027,0.34922243,106.7269809
2504,2589.306441,772,590967.8263,250,0,522,400412.0322,515,7,228.2340232,226.1212723,6000,15041.51486,0.400538924,152.5278995
2507,2594.88563,577,432572.3665,157,0,420,315469.3969,419,1,166.7019007,166.4438842,6000,12105.74935,0.341891788,121.31551
2510,2430.543572,979,732663.1867,220,0,759,571412.531,757,2,301.4400544,300.8437581,6000,23390.40077,0.253370196,234.500304
2513,1938.13635,460,353209.0937,108,0,352,272061.7813,312,40,182.2416126,165.8036618,6000,10749.69785,1.452747747,123.9349293
2516,1213.338914,276,209320.7578,198,0,78,60510.81088,40,38,172.5163146,149.3745348,6000,358.7758541,7.489714859,26.72953829
2519,1206.689649,287,219058.3904,145,0,142,107779.9404,93,49,181.5366449,151.222139,6000,2868.967951,5.903430765,59.00418547
2522,2961.486901,633,478530.4335,118,0,515,389324.8533,513,2,161.584518,161.0454646,6000,13038.4522,0.260614403,130.9235754
2525,1889.915666,423,313315.2927,68,0,355,262401.4969,326,29,165.7826846,154.3175591,6000,11591.27151,1.425358835,127.3778407
2528,1092.737741,440,326613.6096,68,0,372,276878.7662,170,202,298.8947827,161.9038513,6000,-2060.105984,3.848760004,116.3898715
2531,2653.994079,633,468290.6283,113,0,520,382961.9834,488,32,176.447503,167.7230481,6000,12684.75627,0.608952181,135.5720175
2534,1352.179696,320,242804.6008,46,0,274,209194.3334,217,57,179.5653356,147.2682445,6000,9011.479197,2.795893059,122.411883
2537,1063.55105,324,241084.0551,48,0,276,206273.9773,150,126,226.6784045,137.5410354,6000,1567.361732,4.32922343,104.8109865
2540,2540.58516,579,439053.0887,111,0,468,355218.5595,438,30,172.8157338,163.8711854,6000,12192.85187,0.818790902,130.8730672
2543,1424.361213,315,235404.6359,54,0,261,194496.7189,218,43,165.2703217,141.7746828,6000,8955.885932,2.978472528,113.0544982
2546,1249.36113,409,296269.8348,120,0,289,208344.533,171,118,237.1370676,169.0727602,6000,3063.224241,3.439912116,98.69654977
2549,1665.76102,348,264302.0125,72,0,276,208966.8576,268,8,158.6674254,155.3289208,6000,11877.12724,1.096290343,122.109777
2552,1917.686375,605,451280.3814,234,0,371,276752.4302,296,75,235.3254355,206.6618438,6000,8698.860984,2.624970673,115.6522015
2555,2245.089772,532,393210.0395,191,0,341,250024.9132,331,10,175.1422346,171.9986194,6000,10507.79882,0.723863035,108.2216034
2558,2818.439405,731,551246.0621,263,0,468,350789.6896,456,12,195.5855645,192.3805188,6000,11805.22933,0.463670765,121.257339
2561,2424.302504,559,420827.6627,192,0,367,277407.8018,354,13,173.5871089,169.6300566,6000,10651.37778,0.690973939,110.4708301
2564,1630.250902,387,291678.465,81,0,306,230537.0258,246,60,178.9163034,151.7908311,6000,8716.104631,2.476366098,114.2865186
2567,3157.622878,686,509590.3502,138,0,548,407898.1805,548,0,161.3841709,161.3841709,6000,12917.8878,0.194529569,129.178878
2570,1324.249425,421,313284.5327,84,0,337,251424.1271,169,168,236.57517,140.8680505,6000,-155.2629501,3.186915324,94.15448997
2573,1369.360521,512,388074.4799,282,0,230,174868.9753,150,80,283.3983265,238.9140244,6000,3873.259116,3.675692187,83.21689323
2576,1081.607796,243,181413.4557,63,0,180,133372.003,104,76,167.7257287,116.0714729,6000,2000.05137,5.243832073,71.65476951
2579,1994.346104,455,341168.2027,161,0,294,221674.6698,294,0,171.0677008,171.0677008,6000,11115.15546,0.420251382,111.1515546
2582,1232.248313,297,225102.1318,113,0,184,139819.3537,152,32,182.6759505,162.2097143,6000,7253.439312,7.731413546,93.00062936
2585,2750.256297,853,637241.9192,484,0,369,277846.1606,369,0,231.7027398,231.7027398,6000,10102.5552,0.290099164,101.025552
2588,1430.919707,338,251909.6691,66,0,272,202547.5949,209,63,176.0473826,144.114243,6000,7768.435694,3.011550346,109.6174966
2591,2519.88219,769,570196.9114,101,0,668,494932.4846,668,0,226.2791942,226.2791942,6000,19641.09619,0.215080103,196.4109619
2594,2525.587061,558,418868.292,104,0,454,340662.2546,447,7,165.8498725,163.7745181,6000,13073.36751,0.433557504,132.8090295
2597,2057.100514,490,374604.6883,241,0,249,189486.7648,231,18,182.1032496,175.0823537,6000,7807.172608,1.648071552,85.09262192
2600,3047.383927,929,697361.2025,157,0,772,578566.9942,763,9,228.8392993,226.9264913,6000,18603.13262,0.252499741,187.9441342
2603,2989.340202,693,523845.659,75,0,618,466105.7481,594,24,175.2378865,168.4813459,6000,14240.95359,0.463701039,149.1660766
2606,2301.765725,509,378695.0895,108,0,401,300403.0978,366,35,164.523733,153.4941606,6000,10845.07045,1.010783644,119.4802769
2609,2054.392458,486,361072.4416,84,0,402,296332.7899,381,21,175.7563119,168.3045614,6000,12934.00142,0.837747884,136.7917647
2612,2167.929232,852,638912.5508,222,0,630,474292.4402,593,37,294.7109811,282.0230524,6000,19340.08596,0.704050518,206.0887883
2615,1074.55436,252,190432.2152,101,0,151,113098.0172,69,82,177.219713,120.1158672,6000,-895.6602108,5.725143149,48.14724374
2618,2462.114272,785,588381.7107,175,0,610,460175.0265,597,13,238.9741684,235.0577271,6000,17906.95012,0.438887875,182.9859424
2621,2308.299025,747,558313.8971,210,0,537,404404.6154,537,0,241.8724312,241.8724312,6000,17519.59391,0.285135599,175.1959391
2624,1077.101594,327,244863.7496,249,0,78,59480.97665,5,73,227.3357972,176.0399187,6000,-4736.857572,4.88572364,3.927302799
2627,3058.031396,694,516774.5813,141,0,553,414188.0742,553,0,168.9892988,168.9892988,6000,13544.27148,0.208778412,135.4427148
2630,1996.585337,641,480219.4556,131,0,510,379650.871,441,69,240.5203759,215.3966361,6000,13990.26052,1.145683985,165.026345
2633,1313.400794,311,236162.7981,200,0,111,85329.54027,65,46,179.8101532,153.7296224,6000,1280.733218,5.576096102,38.88786308
2636,1457.39651,349,256189.9051,137,0,212,153268.4309,187,25,175.7860015,163.5754342,6000,8074.477594,2.467960104,92.95534319
2639,3026.90901,786,584260.5495,298,0,488,363979.5224,488,0,193.0221713,193.0221713,6000,12024.79233,0.244352936,120.2479233
2642,3163.369641,594,443388.0559,178,0,416,307044.2814,416,0,140.163214,140.163214,6000,9706.241009,0.230873994,97.06241009
2645,1622.86084,377,285939.8807,130,0,247,186724.5947,209,38,176.1949476,157.6676187,6000,7800.42493,2.456331283,96.5315782
2648,2872.839609,628,470361.1929,111,0,517,386555.9001,506,11,163.7269242,160.6020907,6000,12830.56695,0.413037704,131.430503
2651,1716.810154,415,311240.4134,143,0,272,204713.3133,265,7,181.289942,178.1090468,6000,11287.87165,1.045189208,116.0596118
2654,2155.832688,468,348323.1768,167,0,301,223632.6204,297,4,161.5724535,160.324085,6000,10123.70182,0.618494889,102.4853867
2657,2889.436363,638,471028.2253,218,0,420,312015.7179,403,17,163.0173384,158.6702752,6000,9929.085021,0.50390202,103.6379134
2660,2950.564934,825,617293.9548,242,0,583,433696.8607,581,2,209.2121233,208.6544009,6000,14587.22915,0.259508069,146.430014
2663,2589.331502,1012,748554.8524,388,0,624,461179.0171,624,0,289.0919342,289.0919342,6000,17810.73673,0.219995932,178.1073673
2666,1289.352081,298,223605.0806,55,0,243,182337.3924,170,73,173.4243764,131.380381,6000,5732.985404,3.650454801,99.37384938
2669,1825.925824,446,334139.5853,160,0,286,214619.0126,286,0,182.997349,182.997349,6000,11753.98309,0.815606869,117.5398309
2672,1315.067598,524,393973.6183,195,0,329,244957.6172,194,135,299.5843094,223.0519518,6000,3320.526628,3.201687319,109.7376239
2675,1788.486048,541,403158.6189,148,0,393,293625.4703,364,29,225.4189343,213.1109224,6000,13955.94086,1.43746754,151.8674205
2678,2224.459169,850,637727.3434,192,0,658,494694.3628,580,78,286.6887162,259.2928191,6000,16759.6807,0.935087231,194.9927041
2681,3423.323106,689,519474.4933,481,0,208,157206.8793,207,1,151.7456802,151.5848203,6000,4560.058257,0.410699406,45.76144256
2684,3087.600973,565,418247.9033,214,0,351,256806.7991,348,3,135.4604779,134.7375734,6000,8172.776204,0.34985669,82.45066657
2687,1312.990819,306,231640.7839,210,0,96,73563.22424,32,64,176.4222419,139.3026415,6000,-1821.198183,6.902121326,18.90761861
2690,2733.544634,825,616980.1026,195,0,630,468907.5296,629,1,225.7069795,225.3730656,6000,17087.04466,0.233164267,171.2043605
2693,2883.687174,971,725081.3432,286,0,685,511248.8447,681,4,251.4424413,250.3024154,6000,17500.99292,0.238243381,176.1499551
2696,1488.598892,326,245733.6936,87,0,239,180203.8865,213,26,165.0771709,152.70558,6000,9631.285796,2.082798212,108.6844488
2699,1672.341056,541,401127.109,194,0,347,257075.8305,299,48,239.8596313,219.4278072,6000,11285.84826,1.680166449,133.2903067
2702,2487.36489,803,599684.2354,149,0,654,488673.8627,611,43,241.0921847,228.1959104,6000,17066.99265,0.689680377,183.5662008
2705,3346.409375,635,481006.7572,238,0,397,301080.6475,397,0,143.7381693,143.7381693,6000,8997.125391,0.211038501,89.97125391
2708,2682.564069,630,470757.0806,166,0,464,345076.5865,464,0,175.4877306,175.4877306,6000,12863.6848,0.259403052,128.636848
2711,1158.516001,374,275994.9726,91,0,283,207201.6962,222,61,238.2314724,200.8869529,6000,10416.19188,3.830343211,141.5064383
2714,2895.622632,788,581417.7318,231,0,557,411772.9975,557,0,200.7919559,200.7919559,6000,14220.53388,0.218100565,142.2053388
2717,2293.161538,533,397187.4507,154,0,379,280433.5416,378,1,173.2051773,172.9143891,6000,12170.96522,0.391481542,122.0004403
2720,2383.148664,791,591957.3064,144,0,647,483309.4932,625,22,248.3929414,241.5660568,6000,18914.91447,0.338579724,195.9760293
2723,1267.172469,296,223055.9859,70,0,226,170206.7514,155,71,176.0265405,134.2054551,6000,5067.79439,3.737209143,92.49902934
2726,1016.673815,254,191381.965,90,0,164,123830.5448,142,22,188.2432321,172.0813516,6000,8947.591864,5.383759674,105.6377991
2729,1220.040235,293,217917.6248,87,0,206,154391.268,180,26,178.6151133,163.4212065,6000,9615.823267,2.835544798,111.3521394
2732,2752.453765,578,431709.9947,187,0,391,290576.3349,390,1,156.8455028,156.6357386,6000,10515.03956,0.311135353,105.3601598
2735,1385.788396,422,313107.251,83,0,339,251909.9105,230,109,225.9416025,166.4578001,6000,6281.333026,3.114870944,122.2971327
2738,1286.822,311,233686.5689,58,0,253,189588.763,194,59,181.599762,147.0517213,6000,7823.491154,3.32650041,112.7829523
2741,2536.05122,578,437627.4554,157,0,421,317399.648,392,29,172.562546,164.4471252,6000,10892.42205,0.633299639,117.0396413
2744,3246.833287,943,713792.5604,441,0,502,378387.9239,502,0,219.8426889,219.8426889,6000,11654.06075,0.211766993,116.5406075
2747,3412.710664,660,495436.7043,187,0,473,355170.4075,473,0,145.173955,145.173955,6000,10407.28156,0.227697531,104.0728156
2750,2715.335891,841,631325.1363,219,0,622,468559.2849,622,0,232.5035139,232.5035139,6000,17256.03401,0.227077997,172.5603401
2753,1921.663568,436,322288.3834,91,0,345,256354.1679,338,7,167.7132193,165.2303976,6000,12843.65671,0.724659279,130.9193888
2756,2975.735678,806,604131.3427,212,0,594,443323.8666,594,0,203.019155,203.019155,6000,14897.95851,0.198781847,148.9795851
2759,3238.75182,610,454071.7638,137,0,473,354405.3812,471,2,140.1996167,139.8061265,6000,10863.9552,0.23936025,109.0330422
2762,1218.641587,271,202069.6636,54,0,217,163763.5176,174,43,165.8154996,139.5569289,6000,8186.487817,4.408496464,108.1234489
2765,2795.717823,1092,825113.2492,373,0,719,543799.5541,710,9,295.1346672,292.650447,6000,18954.31622,0.298727339,192.0273824
2768,2805.570848,595,444750.1653,148,0,447,333049.387,432,15,158.5239473,154.6283886,6000,11091.89081,0.567919588,114.8144669
2771,3052.634635,614,458345.1423,268,0,346,260685.864,346,0,150.1473963,150.1473963,6000,8539.700789,0.285174495,85.39700789
2774,3237.970327,821,613386.3714,275,0,546,408668.9197,546,0,189.4354517,189.4354517,6000,12621.14468,0.191400507,126.2114468
2777,2328.490562,725,546949.5099,233,0,492,371347.1162,484,8,234.89445,232.1372973,6000,15396.54547,0.484650317,156.7226074
2780,2013.028974,467,348498.6709,292,0,175,130982.4819,172,3,173.1215374,171.7811928,6000,6238.66712,1.047420057,63.72701583
2783,2254.587892,494,371241.945,200,0,294,220919.1201,279,15,164.6606665,160.0681832,6000,8880.150846,0.938594774,93.39399172
2786,3396.674452,936,703216.8469,249,0,687,515635.7049,687,0,207.0309819,207.0309819,6000,15180.60421,0.170032612,151.8060421
2789,2669.558183,607,457747.1269,144,0,463,348832.8764,463,0,171.4692453,171.4692453,6000,13067.06401,0.260739549,130.6706401
2792,3108.719636,855,640471.4348,154,0,701,526185.7909,701,0,206.0241867,206.0241867,6000,16926.12562,0.175599209,169.2612562
2795,2572.539751,973,728949.567,164,0,809,606482.6415,790,19,283.357941,277.8784146,6000,22479.34331,0.368807094,230.2729595
2798,3207.657079,915,686750.5288,324,0,591,445421.7126,591,0,214.0972404,214.0972404,6000,13886.2011,0.190143809,138.862011
2801,2795.805607,898,673423.7459,128,0,770,574008.5147,746,24,240.8693023,234.1607603,6000,19189.35117,0.408356921,198.6020537
2804,2794.540261,1035,783325.4281,115,0,920,698105.571,895,25,280.3056514,273.7088032,6000,23661.68292,0.33401206,243.2136773
2807,2657.090054,1006,759513.1393,103,0,903,679668.9466,870,33,285.8439585,276.8348521,6000,23777.62588,0.42762093,246.7853652
2810,2603.90594,641,479130.0398,168,0,473,353278.9577,473,0,184.0043576,184.0043576,6000,13567.27032,0.260106728,135.6727032
2813,1071.831512,351,260485.0266,70,0,281,206580.4101,242,39,243.0279607,217.1641866,6000,14100.83508,3.460316112,166.8721249
2816,2746.471167,582,436703.8658,149,0,433,322439.1947,433,0,159.0054435,159.0054435,6000,11740.1267,0.268144445,117.401267
2819,1905.235088,719,540348.5403,66,0,653,490733.5602,576,77,283.6125282,252.8733638,6000,19609.28041,1.098400092,226.8319685
2822,2068.574873,676,506614.1608,97,0,579,434772.8446,524,55,244.9097528,224.849363,6000,17005.91129,0.939569359,190.1195027
2825,1308.103139,428,319112.9684,106,0,322,238734.2326,263,59,243.9509232,211.1299535,6000,11686.2196,2.629481736,149.6831658
2828,1845.080039,722,537098.8153,81,0,641,478030.3117,532,109,291.0978407,246.9795563,6000,17084.72117,1.350709305,214.9654961
2831,1487.652653,347,261398.0424,71,0,276,208175.4738,273,3,175.7117442,174.0077705,6000,13652.75903,0.93280927,138.2315639
2834,2112.926569,644,481229.9185,153,0,491,364342.0167,445,46,227.7551551,211.748867,6000,14042.21985,0.969662682,156.4284865
2837,2122.895416,507,379486.0591,149,0,358,268650.4209,358,0,178.7587161,178.7587161,6000,12654.90607,0.373708143,126.5490607
2840,1941.85202,447,333308.6868,76,0,371,275644.099,351,20,171.6447409,164.2009151,6000,12706.14239,0.998257421,134.5052497
2843,2171.566112,518,385931.7602,81,0,437,327094.0139,410,27,177.7204747,168.3976338,6000,13198.01786,0.73299655,141.3030195
2846,1009.986888,238,177879.5418,77,0,161,119664.932,107,54,176.1206446,135.997839,6000,3823.605766,5.642544609,78.35886325
2849,3055.166663,743,562362.0306,166,0,577,436053.0152,569,8,184.0691827,182.0914879,6000,13877.10354,0.346452413,140.7487301
2852,1806.558236,437,324060.5064,108,0,329,243142.4499,310,19,179.3800498,171.3012119,6000,11843.10936,1.186521778,126.5099315
2855,3213.09198,545,405004.1395,114,0,431,320505.975,431,0,126.0481001,126.0481001,6000,9975.001555,0.248684639,99.75001555
2858,1256.15268,279,205201.6436,66,0,213,155535.2861,149,64,163.357247,126.4274377,6000,4995.91564,4.612897392,86.88896573
2861,2744.49014,809,613457.0444,200,0,609,460658.3527,598,11,223.5231366,220.7117944,6000,16222.57425,0.453688599,165.0370847
2864,2429.834274,747,562132.8371,172,0,575,432043.985,558,17,231.3461635,226.5416655,6000,16819.90092,0.505374477,173.0035072
2867,2533.82217,536,405448.5367,63,0,473,358219.6267,439,34,160.0145983,149.4846248,6000,12031.52572,0.786081741,130.8452307
2870,1460.31238,345,257199.606,195,0,150,110171.977,109,41,176.1264299,155.8688695,6000,3492.899559,3.788750423,55.18655594
2873,1609.594078,377,288255.7967,133,0,244,185560.0564,180,64,179.0860196,149.2208011,6000,5555.332234,2.696793173,85.41854086
2876,1147.695257,273,205975.7762,65,0,208,157770.6907,121,87,179.4690488,123.1769141,6000,2488.313733,5.279661995,81.17527202
2879,1553.50826,495,374339.2241,148,0,347,262032.943,261,86,240.963781,199.5204887,6000,8578.515655,3.197951593,127.2284488
2882,1202.785245,370,273365.2181,89,0,281,209123.7418,132,149,227.2768303,133.6263033,6000,-1343.481917,3.798236791,80.21570777
2885,1511.59173,583,440715.6183,165,0,418,315317.5119,275,143,291.5573099,221.36392,6000,6821.28744,2.349322678,138.4062643
2888,3030.912766,637,474798.4571,166,0,471,351227.4391,454,17,156.6519705,152.4160383,6000,10740.98738,0.532489049,111.6458059
2891,3027.136639,658,495190.959,188,0,470,351210.7034,467,3,163.5839468,162.7655428,6000,11438.39553,0.300277181,115.2023593
2894,3157.11582,609,459866.7937,135,0,474,359275.4373,472,2,145.6604128,145.1596922,6000,11279.71832,0.227266701,113.2979038
2897,2912.67659,646,485520.4891,193,0,453,339113.9012,450,3,166.692207,165.9049598,6000,11485.24038,0.362249094,115.6396511
2900,2000.378329,441,329641.5668,65,0,376,281367.5294,361,15,164.7896111,159.2232396,6000,12952.44145,0.868849811,135.0907859
2903,1177.135865,296,224016.9703,109,0,187,141695.0647,128,59,190.306809,151.2856851,6000,4233.048806,6.627049069,81.35161202
2906,1297.925488,284,211875.3561,34,0,250,186192.9459,195,55,163.2415404,131.2341819,6000,7943.954717,3.124106481,111.4469057
2909,2171.782304,857,635608.3647,84,0,773,572926.5764,705,68,292.6667021,269.5028885,6000,21747.71635,0.832208283,240.6409771
2912,1960.381663,424,324475.3199,32,0,392,298971.1517,321,71,165.5164023,138.5087592,6000,9849.131878,1.686822151,125.4989618
2915,1707.132788,514,386222.941,96,0,418,312429.4636,380,38,226.240714,209.273379,6000,14907.94843,1.209422411,166.0468193
2918,1841.127831,431,324677.1838,49,0,382,288240.1309,311,71,176.346899,147.4749816,6000,9881.244866,1.637649347,127.6843661
2921,2559.61007,978,732051.6308,148,0,830,619054.7477,787,43,286.0012309,273.0825197,6000,21601.76768,0.536506756,228.936388
2924,2133.888196,839,626816.0008,130,0,709,529472.7216,679,30,293.7436,282.4208385,6000,22548.02797,0.551112595,236.8030412
2927,2002.937081,801,597668.7574,109,0,692,518107.7362,604,88,298.3961718,265.5216062,6000,19292.48636,1.048938372,225.7994292
2930,1838.700115,597,441967.2865,253,0,344,259382.1507,333,11,240.3694235,236.2202197,6000,13276.98117,0.947177604,136.9190154
2933,1559.835749,370,275648.4303,163,0,207,155940.8223,167,40,176.7163181,157.0181726,6000,6057.630074,4.247370042,80.27444619
2936,2929.383784,605,460066.8301,186,0,419,319027.1815,417,2,157.052426,156.4982484,6000,10779.75461,0.351500737,108.3517238
2939,1236.334806,387,291725.8836,136,0,251,187693.0781,163,88,235.960261,183.0617266,6000,4601.704916,3.946242066,98.91558353
2942,3037.244807,736,549241.6735,300,0,436,326748.4578,435,1,180.8354968,180.6262617,6000,10716.20768,0.263446037,107.3713119
2945,1890.345942,604,454665.6427,163,0,441,332447.8753,405,36,240.5198078,226.5889008,6000,14800.43426,1.280372678,161.9352495
2948,2177.205601,716,528291.2962,212,0,504,373507.9209,475,29,242.6464897,232.7588102,6000,15177.84534,0.648577805,161.6661329
2951,3223.831793,578,435464.7723,324,0,254,191544.4772,251,3,135.0767658,134.3031886,6000,5786.800415,0.584201702,58.64158135
2954,1421.578894,452,341863.2804,95,0,357,272712.7486,249,108,240.4813985,183.4198299,6000,7771.47903,2.760793228,134.7763589
2957,1987.679612,489,360612.704,82,0,407,299578.4722,380,27,181.4239588,171.1565262,6000,13018.28211,0.844215039,140.4502537
2960,2492.616884,770,576904.9726,428,0,342,258226.9496,342,0,231.4455046,231.4455046,6000,10359.67265,0.319295305,103.5967265
2963,2338.797359,694,523057.7726,299,0,395,298297.553,390,5,223.6439042,221.9917295,6000,12423.8788,0.682668307,125.8909627
2966,3426.358059,589,443985.5847,329,0,260,195373.5645,260,0,129.5794476,129.5794476,6000,5702.0767,0.268787362,57.020767
2969,1644.630729,383,289172.2362,71,0,312,235794.9949,287,25,175.8280635,165.0506633,6000,12181.78064,2.121735318,132.5952066
2972,2970.658768,678,514048.0718,114,0,564,426746.1016,559,5,173.0417769,171.8079285,6000,14118.59959,0.296658271,142.4198443
2975,2785.392774,618,464626.1045,133,0,485,365527.144,453,32,166.8081101,158.4457881,6000,11450.53742,0.273009807,122.8676961
2978,2627.611236,753,567592.9488,535,0,218,164011.7806,218,0,216.0110069,216.0110069,6000,6241.858704,0.591713276,62.41858704
2981,2679.439022,611,455987.2728,355,0,256,191553.054,256,0,170.1801269,170.1801269,6000,7148.998445,0.368892396,71.48998445
2984,3056.695622,948,708320.8088,410,0,538,400030.0505,532,6,231.7276224,230.1410225,6000,12769.68966,0.357295172,129.2834965
2987,3203.183918,641,490384.2861,279,0,362,280668.4378,361,1,153.0927661,152.7878926,6000,8701.195859,0.412738097,87.31683203
2990,1745.687937,419,315985.2158,160,0,259,194508.142,239,20,181.0089931,172.5143692,6000,9443.28098,0.730559509,102.9274337
2993,2922.882669,638,479402.0728,559,0,79,57928.79148,79,0,164.016872,164.016872,6000,1981.906153,0.554957643,19.81906153
2996,2908.586405,847,629599.7569,584,0,263,198906.7298,263,0,216.4624561,216.4624561,6000,6838.60481,0.329090772,68.3860481
2999,2224.07342,695,520026.7589,556,0,139,104335.6749,139,0,233.8172626,233.8172626,6000,4691.197417,0.792973231,46.91197417
3002,2450.333468,587,436080.7316,205,0,382,281246.5468,382,0,177.9679122,177.9679122,6000,11477.88864,0.35317245,114.7788864
3005,2459.899061,590,441677.811,158,0,432,327791.4328,432,0,179.551193,179.551193,6000,13325.40176,0.353438527,133.2540176
3008,3288.850596,648,479654.3381,170,0,478,352769.0867,478,0,145.8425441,145.8425441,6000,10726.21198,0.241981532,107.2621198
3011,2141.556686,518,386267.985,119,0,399,295656.8627,355,44,180.3678546,164.9224185,6000,10716.61145,1.260255763,122.6115505
